win_seed,lose_seed,win_pts,lose_pts,win_school_ncaa,pt_differ,season,round
11,6,94,90,Evansville,4,1989,64
14,6,75,63,Chattanooga,12,1997,32
14,3,73,70,Chattanooga,3,1997,64
4,13,61,39,Temple,22,1994,64
8,9,60,57,Temple,3,1985,64
10,7,80,63,Temple,17,1991,64
1,8,74,53,Temple,21,1988,32
6,10,77,55,Temple,22,1999,16
6,3,64,54,Temple,10,1999,32
1,13,69,47,Temple,22,1988,16
9,8,76,72,Temple,4,2013,64
10,3,72,63,Temple,9,1991,16
2,15,73,47,Temple,26,2000,64
1,16,87,73,Temple,14,1988,64
10,15,77,64,Temple,13,1991,32
6,11,61,54,Temple,7,1999,64
9,8,61,50,Temple,11,1986,64
7,10,66,64,Temple,2,2011,64
7,10,61,43,Temple,18,1996,64
9,8,62,40,Temple,22,1997,64
2,15,75,56,Temple,19,1987,64
11,6,79,65,Temple,14,2001,64
7,10,75,61,Temple,14,1993,64
7,3,67,59,Temple,8,1993,16
11,3,75,54,Temple,21,2001,32
11,7,84,72,Temple,12,2001,16
7,15,68,57,Temple,11,1993,32
5,12,88,42,VCU,46,2013,64
2,15,81,65,VCU,16,1985,64
12,5,62,59,VCU,3,2012,64
11,1,71,61,VCU,10,2011,8
11,10,72,71,VCU,1,2011,16
11,6,79,77,VCU,2,2007,64
11,3,94,76,VCU,18,2011,32
11,6,74,56,VCU,18,2011,64
11,11,59,46,VCU,13,2011,68
10,7,75,67,VCU,8,2016,64
8,9,84,72,Colorado St.,12,2013,64
10,7,68,46,Colorado St.,22,1989,64
8,9,74,68,Rhode Island,6,1993,64
11,3,97,94,Rhode Island,3,1988,32
11,6,87,80,Rhode Island,7,1988,64
8,13,74,68,Rhode Island,6,1998,16
8,1,80,75,Rhode Island,5,1998,32
11,6,84,72,Rhode Island,12,2017,64
8,9,97,74,Rhode Island,23,1998,64
5,12,57,50,Utah,7,2015,64
4,5,73,67,Utah,6,1996,32
3,14,80,69,Utah,11,2016,64
5,4,75,64,Utah,11,2015,32
3,1,65,59,Utah,6,1998,4
2,15,80,58,Utah,22,1999,64
3,14,85,68,Utah,17,1998,64
3,10,65,62,Utah,3,1998,16
3,1,76,51,Utah,25,1998,8
3,6,75,69,Utah,6,1998,32
4,13,72,43,Utah,29,1996,64
4,13,76,64,Utah,12,1995,64
8,9,86,65,Utah,21,1993,64
8,9,48,45,Utah,3,2000,64
6,11,60,54,Utah,6,2005,64
9,8,60,58,Utah,2,2003,64
6,3,67,58,Utah,9,2005,32
2,7,77,58,Utah,19,1997,32
4,5,85,84,Utah,1,1991,32
2,15,75,61,Utah,14,1997,64
4,13,82,72,Utah,10,1991,64
2,6,82,77,Utah,5,1997,16
8,9,77,62,Charlotte,15,1998,64
5,12,81,70,Charlotte,11,1999,64
9,8,70,63,Charlotte,7,2001,64
7,10,79,67,Charlotte,12,1997,64
3,14,91,73,Baylor,18,2017,64
3,11,82,78,Baylor,4,2017,32
3,11,76,68,Baylor,8,2010,32
3,14,68,59,Baylor,9,2010,64
3,10,72,49,Baylor,23,2010,16
3,10,75,70,Baylor,5,2012,16
3,14,68,60,Baylor,8,2012,64
3,11,80,63,Baylor,17,2012,32
6,11,74,60,Baylor,14,2014,64
6,3,85,55,Baylor,30,2014,32
14,3,78,71,Mercer,7,2014,64
12,4,81,51,Missouri St.,30,1999,32
12,5,43,32,Missouri St.,11,1999,64
13,4,65,60,Missouri St.,5,1987,64
9,8,59,55,Bucknell,4,2006,64
14,3,64,63,Bucknell,1,2005,64
12,5,80,75,North Dakota St.,5,2014,64
12,12,65,54,South Fla.,11,2012,68
12,5,58,44,South Fla.,14,2012,64
2,7,92,87,Oregon,5,2002,32
2,15,81,62,Oregon,19,2002,64
2,6,72,70,Oregon,2,2002,16
3,14,93,77,Oregon,16,2017,64
3,7,69,68,Oregon,1,2017,16
3,11,75,61,Oregon,14,2007,32
12,4,74,57,Oregon,17,2013,32
12,5,68,55,Oregon,13,2013,64
3,1,74,60,Oregon,14,2017,8
3,11,75,72,Oregon,3,2017,32
3,7,76,72,Oregon,4,2007,16
3,14,58,56,Oregon,2,2007,64
7,10,87,68,Oregon,19,2014,64
8,9,79,73,Oregon,6,2015,64
1,16,91,52,Oregon,39,2016,64
1,4,82,68,Oregon,14,2016,16
1,8,69,64,Oregon,5,2016,32
16,16,68,55,James Madison,13,2013,68
10,2,75,68,Saint Mary's (CA),7,2010,32
10,7,80,71,Saint Mary's (CA),9,2010,64
7,10,85,77,Saint Mary's (CA),8,2017,64
11,11,67,54,Saint Mary's (CA),13,2013,68
16,16,71,49,Monmouth,22,2006,68
6,11,60,59,Saint Joseph's,1,1986,64
9,8,66,62,Saint Joseph's,4,2001,64
1,8,70,65,Saint Joseph's,5,2004,32
1,16,82,63,Saint Joseph's,19,2004,64
1,4,84,80,Saint Joseph's,4,2004,16
8,9,78,76,Saint Joseph's,2,2016,64
4,5,81,77,Saint Joseph's,4,1997,32
4,13,75,65,Saint Joseph's,10,1997,64
2,3,98,90,Georgetown,8,1996,16
1,16,50,49,Georgetown,1,1989,64
1,16,68,43,Georgetown,25,1985,64
1,5,69,61,Georgetown,8,1989,16
1,2,60,54,Georgetown,6,1985,8
8,9,66,63,Georgetown,3,1988,64
2,1,96,84,Georgetown,12,2007,8
1,8,63,46,Georgetown,17,1985,32
2,7,62,55,Georgetown,7,2007,32
2,15,93,56,Georgetown,37,1996,64
1,1,77,59,Georgetown,18,1985,4
1,9,81,74,Georgetown,7,1989,32
1,4,65,53,Georgetown,12,1985,16
2,15,80,55,Georgetown,25,2007,64
2,7,73,62,Georgetown,11,1996,32
2,6,66,65,Georgetown,1,2007,16
1,16,75,53,Georgetown,22,1987,64
4,13,84,74,Georgetown,10,2015,64
6,11,75,60,Georgetown,15,1992,64
3,14,70,52,Georgetown,18,1990,64
10,15,76,57,Georgetown,19,2001,32
2,15,66,47,Georgetown,19,2008,64
1,5,70,57,Georgetown,13,1987,16
1,9,82,79,Georgetown,3,1987,32
3,14,74,59,Georgetown,15,2012,64
10,7,63,61,Georgetown,2,2001,64
4,13,70,64,Georgetown,6,1986,64
7,2,70,52,Georgetown,18,2006,32
7,10,54,49,Georgetown,5,2006,64
9,8,84,77,Georgetown,7,1994,64
8,9,70,60,Georgetown,10,1991,64
6,14,53,51,Georgetown,2,1995,32
6,11,68,63,Georgetown,5,1995,64
11,3,149,115,Loyola Marymount,34,1990,32
10,7,119,115,Loyola Marymount,4,1988,64
11,7,62,60,Loyola Marymount,2,1990,16
11,6,111,92,Loyola Marymount,19,1990,64
3,14,62,57,New Mexico,5,2010,64
3,14,59,55,New Mexico,4,1997,64
7,10,69,48,New Mexico,21,1996,64
5,12,75,68,New Mexico,7,2012,64
9,8,61,59,New Mexico,2,1999,64
4,13,79,62,New Mexico,17,1998,64
11,6,77,57,Pepperdine,20,2000,64
16,16,73,72,N.C. A&T,1,2013,68
16,16,67,63,UC Davis,4,2017,68
12,5,77,68,Utah St.,9,2001,64
12,5,66,58,Texas A&M,8,2006,64
3,14,68,52,Texas A&M,16,2007,64
3,6,72,69,Texas A&M,3,2007,32
5,12,69,53,Texas A&M,16,2010,64
9,8,67,62,Texas A&M,5,2008,64
9,8,79,66,Texas A&M,13,2009,64
3,11,92,88,Texas A&M,4,2016,32
3,14,92,65,Texas A&M,27,2016,64
7,10,93,79,New Mexico St.,14,1993,64
12,13,81,73,New Mexico St.,8,1992,32
12,5,81,73,New Mexico St.,8,1992,64
2,15,68,50,San Diego St.,18,2011,64
8,9,76,64,San Diego St.,12,2015,64
2,7,71,64,San Diego St.,7,2011,32
7,10,70,55,San Diego St.,15,2013,64
4,13,73,69,San Diego St.,4,2014,64
4,12,63,44,San Diego St.,19,2014,32
13,5,72,66,Bradley,6,2006,32
13,4,77,73,Bradley,4,2006,64
7,10,83,65,Bradley,18,1986,64
7,10,68,56,UCLA,12,1990,64
7,2,71,70,UCLA,1,1990,32
4,13,61,48,UCLA,13,2001,64
6,11,65,64,UCLA,1,2009,64
4,12,75,50,UCLA,25,2001,32
1,8,75,74,UCLA,1,1995,32
2,10,62,59,UCLA,3,2006,32
1,8,85,69,UCLA,16,1992,32
1,5,86,67,UCLA,19,1995,16
1,2,89,78,UCLA,11,1995,2
1,16,73,53,UCLA,20,1992,64
1,4,74,61,UCLA,13,1995,4
2,4,59,45,UCLA,14,2006,4
1,2,102,96,UCLA,6,1995,8
4,12,77,60,UCLA,17,2014,32
1,16,92,56,UCLA,36,1995,64
2,15,78,44,UCLA,34,2006,64
2,3,73,71,UCLA,2,2006,16
4,13,76,59,UCLA,17,2014,64
11,14,92,75,UCLA,17,2015,32
11,6,60,59,UCLA,1,2015,64
1,12,85,78,UCLA,7,1992,16
2,1,50,45,UCLA,5,2006,8
2,7,96,83,UCLA,13,1997,32
7,10,78,76,UCLA,2,2011,64
2,15,109,75,UCLA,34,1997,64
6,11,65,57,UCLA,8,2000,64
6,3,105,70,UCLA,35,2000,32
2,6,74,73,UCLA,1,1997,16
8,1,105,101,UCLA,4,2002,32
2,7,54,49,UCLA,5,2007,32
7,10,84,74,UCLA,10,1989,64
3,6,79,67,UCLA,12,2017,32
1,3,76,57,UCLA,19,2008,8
6,11,65,62,UCLA,3,1998,64
2,3,64,55,UCLA,9,2007,16
9,8,81,70,UCLA,11,1993,64
6,3,85,82,UCLA,3,1998,32
3,14,97,80,UCLA,17,2017,64
1,9,51,49,UCLA,2,2008,32
1,16,70,29,UCLA,41,2008,64
1,12,88,78,UCLA,10,2008,16
4,13,92,73,UCLA,19,1987,64
2,1,68,55,UCLA,13,2007,8
8,9,80,58,UCLA,22,2002,64
2,15,70,42,UCLA,28,2007,64
14,3,64,63,Northwestern St.,1,2006,64
16,16,71,67,Northwestern St.,4,2001,68
16,16,96,65,FGCU,31,2016,68
15,7,81,71,FGCU,10,2013,32
15,2,78,68,FGCU,10,2013,64
11,6,74,64,Winthrop,10,2007,64
15,2,78,65,Coppin St.,13,1997,64
16,16,58,43,Morehead St.,15,2009,68
13,4,62,61,Morehead St.,1,2011,64
12,13,71,68,Eastern Mich.,3,1991,32
12,5,76,56,Eastern Mich.,20,1991,64
9,8,75,60,Eastern Mich.,15,1996,64
9,5,77,68,Boston College,9,1994,16
7,10,84,75,Boston College,9,2007,64
3,14,68,65,Boston College,3,2001,64
9,8,67,64,Boston College,3,1994,64
9,1,75,72,Boston College,3,1994,32
4,13,85,65,Boston College,20,2005,64
11,3,74,73,Boston College,1,1985,32
11,6,64,51,Boston College,13,1996,64
4,13,88,76,Boston College,12,2006,64
11,6,55,53,Boston College,2,1985,64
4,12,69,56,Boston College,13,2006,32
6,11,58,51,Boston College,7,2004,64
5,12,73,66,Boston College,7,1997,64
11,6,66,53,Dayton,13,2015,64
11,11,56,55,Dayton,1,2015,68
11,10,82,72,Dayton,10,2014,16
12,5,88,86,Dayton,2,1990,64
11,6,60,59,Dayton,1,2014,64
11,3,55,53,Dayton,2,2014,32
11,6,68,60,Dayton,8,2009,64
9,8,70,69,Providence,1,2016,64
6,2,103,82,Providence,21,1987,16
10,7,81,59,Providence,22,1997,64
6,11,90,68,Providence,22,1987,64
10,14,71,65,Providence,6,1997,16
10,2,98,87,Providence,11,1997,32
6,14,90,87,Providence,3,1987,32
6,1,88,73,Providence,15,1987,8
5,3,77,65,Florida,12,2000,8
5,12,69,68,Florida,1,2000,64
4,13,80,65,Florida,15,2017,64
6,11,82,70,Florida,12,1987,64
4,5,65,39,Florida,26,2017,32
3,11,70,58,Florida,12,1994,32
5,4,93,76,Florida,17,2000,32
3,2,69,60,Florida,9,1994,16
5,1,87,78,Florida,9,2000,16
4,8,84,83,Florida,1,2017,16
3,14,64,62,Florida,2,1994,64
5,8,71,59,Florida,12,2000,4
3,9,74,66,Florida,8,1994,8
6,3,85,66,Florida,19,1987,32
1,11,62,52,Florida,10,2014,8
3,11,78,64,Florida,14,2013,32
1,16,67,55,Florida,12,2014,64
3,15,62,50,Florida,12,2013,16
1,9,61,45,Florida,16,2014,32
3,14,79,47,Florida,32,2013,64
1,4,79,68,Florida,11,2014,16
2,15,85,55,Florida,30,2003,64
3,2,73,57,Florida,16,2006,2
3,7,57,53,Florida,4,2006,16
1,2,76,66,Florida,10,2007,4
2,15,79,51,Florida,28,2011,64
3,11,73,58,Florida,15,2006,4
1,3,85,77,Florida,8,2007,8
1,5,65,57,Florida,8,2007,16
1,16,112,69,Florida,43,2007,64
2,3,83,74,Florida,9,2011,16
3,1,75,62,Florida,13,2006,8
2,7,73,65,Florida,8,2011,32
1,9,74,67,Florida,7,2007,32
1,1,84,75,Florida,9,2007,2
3,14,76,50,Florida,26,2006,64
3,11,82,60,Florida,22,2006,32
6,14,82,74,Florida,8,1999,32
6,11,62,59,Florida,3,1988,64
6,11,75,61,Florida,14,1999,64
4,13,67,62,Florida,5,2005,64
7,15,84,50,Florida,34,2012,32
3,14,69,56,Florida,13,2001,64
7,3,68,58,Florida,10,2012,16
7,10,71,45,Florida,26,2012,64
9,8,61,48,Virginia Tech,13,1996,64
5,12,54,52,Virginia Tech,2,2007,64
7,10,85,74,UTEP,11,1989,64
11,6,79,75,UTEP,4,1985,64
9,1,66,60,UTEP,6,1992,32
9,8,55,50,UTEP,5,1992,64
7,10,98,91,UTEP,7,1987,64
2,15,101,52,Syracuse,49,1986,64
3,14,77,60,Syracuse,17,2011,64
3,1,95,84,Syracuse,11,2003,4
3,14,69,55,Syracuse,14,1988,64
7,10,70,65,Syracuse,5,1985,64
2,6,77,63,Syracuse,14,1987,4
4,13,81,34,Syracuse,47,2013,64
3,2,81,78,Syracuse,3,2003,2
3,14,76,65,Syracuse,11,2003,64
3,6,68,56,Syracuse,12,2003,32
3,1,63,47,Syracuse,16,2003,8
1,16,72,65,Syracuse,7,2012,64
4,3,55,39,Syracuse,16,2013,8
1,8,75,59,Syracuse,16,2012,32
2,6,87,81,Syracuse,6,1987,16
2,15,79,73,Syracuse,6,1987,64
3,10,79,78,Syracuse,1,2003,16
4,1,61,50,Syracuse,11,2013,16
6,11,51,43,Syracuse,8,1992,64
2,1,79,75,Syracuse,4,1987,8
4,12,66,60,Syracuse,6,2013,32
2,10,104,86,Syracuse,18,1987,32
1,4,64,63,Syracuse,1,2012,16
10,15,75,50,Syracuse,25,2016,32
10,11,63,60,Syracuse,3,2016,16
10,7,70,51,Syracuse,19,2016,64
3,14,77,53,Syracuse,24,2014,64
3,14,59,44,Syracuse,15,2009,64
3,6,78,67,Syracuse,11,2009,32
5,12,80,75,Syracuse,5,2004,64
5,4,72,70,Syracuse,2,2004,32
10,1,68,62,Syracuse,6,2016,8
7,10,96,92,Syracuse,4,1995,64
2,15,104,81,Syracuse,23,1989,64
5,12,79,69,Syracuse,10,2001,64
4,13,79,65,Syracuse,14,2000,64
2,10,65,50,Syracuse,15,1989,32
2,15,70,48,Syracuse,22,1990,64
4,5,52,50,Syracuse,2,2000,32
2,7,63,61,Syracuse,2,1990,32
2,3,83,80,Syracuse,3,1989,16
4,5,77,69,Syracuse,8,1996,4
4,12,69,58,Syracuse,11,1996,32
4,8,83,81,Syracuse,2,1996,16
4,13,88,55,Syracuse,33,1996,64
1,16,79,56,Syracuse,23,2010,64
5,4,56,46,Syracuse,10,1998,32
4,12,64,59,Syracuse,5,1994,32
4,2,60,57,Syracuse,3,1996,8
1,8,87,65,Syracuse,22,2010,32
4,13,92,78,Syracuse,14,1994,64
5,12,63,61,Syracuse,2,1998,64
14,3,78,75,Murray St.,3,1988,64
6,11,58,41,Murray St.,17,2012,64
13,4,66,65,Murray St.,1,2010,64
4,12,85,70,UNLV,15,1989,32
4,13,85,80,UNLV,5,1985,64
4,1,68,67,UNLV,1,1989,16
4,13,68,56,UNLV,12,1989,64
8,9,71,58,UNLV,13,2008,64
7,10,67,63,UNLV,4,2007,64
7,2,74,68,UNLV,6,2007,32
1,16,102,72,UNLV,30,1990,64
1,4,90,81,UNLV,9,1990,4
1,4,83,66,UNLV,17,1991,16
1,9,80,61,UNLV,19,1987,32
1,3,103,73,UNLV,30,1990,2
1,8,76,65,UNLV,11,1990,32
1,2,84,81,UNLV,3,1987,8
1,8,62,54,UNLV,8,1991,32
1,11,131,101,UNLV,30,1990,8
4,13,54,50,UNLV,4,1988,64
1,16,95,70,UNLV,25,1987,64
1,12,69,67,UNLV,2,1990,16
4,5,70,64,UNLV,6,1986,32
4,13,74,51,UNLV,23,1986,64
1,12,92,78,UNLV,14,1987,16
1,3,77,65,UNLV,12,1991,8
1,16,99,65,UNLV,34,1991,64
9,8,72,70,Ole Miss,2,1999,64
3,14,72,70,Ole Miss,2,2001,64
3,6,59,56,Ole Miss,3,2001,32
12,5,57,46,Ole Miss,11,2013,64
11,11,94,90,Ole Miss,4,2015,68
14,3,80,78,Siena,2,1989,64
16,16,81,77,Siena,4,2002,68
13,4,83,62,Siena,21,2008,64
9,8,74,72,Siena,2,2009,64
4,2,70,60,LSU,10,2006,8
4,1,62,54,LSU,8,2006,16
4,13,80,64,LSU,16,2006,64
4,12,58,57,LSU,1,2006,32
8,9,75,71,LSU,4,2009,64
7,10,94,83,LSU,11,1992,64
11,3,83,81,LSU,2,1986,32
5,12,70,63,LSU,7,1990,64
10,3,63,58,LSU,5,1987,16
11,1,59,57,LSU,2,1986,8
11,2,70,64,LSU,6,1986,16
10,7,85,79,LSU,6,1987,64
11,6,94,87,LSU,7,1986,64
10,2,72,62,LSU,10,1987,32
4,13,64,61,LSU,3,2000,64
4,5,72,67,LSU,5,2000,32
10,2,68,62,Auburn,6,2003,32
10,7,65,63,Auburn,2,2003,64
8,9,90,86,Auburn,4,1988,64
1,16,80,41,Auburn,39,1999,64
7,10,72,69,Auburn,3,2000,64
8,9,62,61,Auburn,1,1987,64
1,9,81,74,Auburn,7,1999,32
8,4,70,63,Auburn,7,1986,16
11,3,66,64,Auburn,2,1985,32
8,1,81,65,Auburn,16,1986,32
11,6,59,58,Auburn,1,1985,64
8,9,73,63,Auburn,10,1986,64
12,12,70,52,Clemson,18,2011,68
5,4,79,75,Clemson,4,1990,32
5,12,49,47,Clemson,2,1990,64
9,8,83,70,Clemson,13,1989,64
4,13,68,56,Clemson,12,1997,64
4,5,65,59,Clemson,6,1997,32
8,9,71,66,Memphis,5,2014,64
1,16,94,78,Memphis,16,2006,64
1,9,72,56,Memphis,16,2006,32
2,7,78,62,Memphis,16,2007,32
9,8,75,60,Memphis,15,1988,64
1,13,80,64,Memphis,16,2006,16
2,3,65,64,Memphis,1,2007,16
2,15,73,58,Memphis,15,2007,64
6,11,54,52,Memphis,2,2013,64
6,3,75,73,Memphis,2,1995,32
1,5,92,74,Memphis,18,2008,16
2,1,63,61,Memphis,2,1985,8
1,16,87,63,Memphis,24,2008,64
6,3,82,80,Memphis,2,1992,32
1,2,85,67,Memphis,18,2008,8
1,1,78,63,Memphis,15,2008,4
2,7,67,66,Memphis,1,1985,32
2,11,59,57,Memphis,2,1985,16
6,11,80,70,Memphis,10,1992,64
3,14,95,63,Memphis,32,1986,64
1,8,77,74,Memphis,3,2008,32
7,10,59,43,Memphis,16,2004,64
6,7,83,79,Memphis,4,1992,16
2,15,67,55,Memphis,12,1985,64
6,11,77,56,Memphis,21,1995,64
2,10,89,70,Memphis,19,2009,32
2,15,81,70,Memphis,11,2009,64
8,9,79,71,Pacific,8,2005,64
12,5,66,58,Pacific,8,2004,64
10,7,86,78,Missouri,8,2010,64
5,12,89,78,Missouri,11,1992,64
9,8,70,68,Missouri,2,2001,64
8,9,65,60,Missouri,5,1995,64
3,14,85,69,Missouri,16,1989,64
3,11,108,89,Missouri,19,1989,32
6,11,72,71,Missouri,1,2003,64
3,14,78,59,Missouri,19,2009,64
12,8,82,73,Missouri,9,2002,16
1,16,76,53,Missouri,23,1994,64
12,5,93,80,Missouri,13,2002,64
3,6,83,79,Missouri,4,2009,32
1,4,98,88,Missouri,10,1994,16
1,9,109,96,Missouri,13,1994,32
3,2,102,91,Missouri,11,2009,16
12,4,83,67,Missouri,16,2002,32
5,12,69,57,Princeton,12,1998,64
13,4,43,41,Princeton,2,1996,64
10,7,66,64,Detroit Mercy,2,1998,64
12,5,56,53,Detroit Mercy,3,1999,64
7,10,47,43,Wisconsin,4,2016,64
4,13,53,49,Wisconsin,4,2010,64
4,13,73,49,Wisconsin,24,2012,64
8,9,84,74,Wisconsin,10,2017,64
4,5,60,57,Wisconsin,3,2012,32
8,1,65,62,Wisconsin,3,2017,32
12,5,61,59,Wisconsin,2,2009,64
7,2,66,63,Wisconsin,3,2016,32
8,9,80,70,Wisconsin,10,2002,64
3,11,72,55,Wisconsin,17,2008,32
3,14,71,56,Wisconsin,15,2008,64
5,13,61,60,Wisconsin,1,2003,32
4,5,70,65,Wisconsin,5,2011,32
5,12,81,74,Wisconsin,7,2003,64
6,11,76,64,Wisconsin,12,2004,64
4,13,72,58,Wisconsin,14,2011,64
2,15,76,63,Wisconsin,13,2007,64
6,10,65,56,Wisconsin,9,2005,16
2,1,64,63,Wisconsin,1,2014,8
2,15,75,35,Wisconsin,40,2014,64
6,11,57,52,Wisconsin,5,2005,64
2,6,69,52,Wisconsin,17,2014,16
8,6,64,60,Wisconsin,4,2000,8
8,4,61,48,Wisconsin,13,2000,16
9,8,80,72,Wisconsin,8,1994,64
1,4,79,72,Wisconsin,7,2015,16
8,1,66,59,Wisconsin,7,2000,32
6,14,71,62,Wisconsin,9,2005,32
1,2,85,78,Wisconsin,7,2015,8
8,9,66,56,Wisconsin,10,2000,64
1,8,72,65,Wisconsin,7,2015,32
1,1,71,64,Wisconsin,7,2015,4
2,7,85,77,Wisconsin,8,2014,32
1,16,86,72,Wisconsin,14,2015,64
12,4,87,69,Cornell,18,2010,32
12,5,78,65,Cornell,13,2010,64
11,6,82,68,UAB,14,2005,64
14,3,60,59,UAB,1,2015,64
7,10,70,68,UAB,2,1985,64
6,11,66,64,UAB,2,1986,64
9,8,102,100,UAB,2,2004,64
9,1,76,75,UAB,1,2004,32
13,4,65,60,Ohio,5,2012,64
13,12,62,56,Ohio,6,2012,32
14,3,97,83,Ohio,14,2010,64
15,2,64,61,Santa Clara,3,1993,64
10,7,91,79,Santa Clara,12,1996,64
11,6,75,72,Western Mich.,3,1998,64
7,10,80,71,BYU,9,1993,64
3,14,74,66,BYU,8,2011,64
4,13,98,92,BYU,6,1988,64
3,11,89,67,BYU,22,2011,32
14,14,78,72,BYU,6,2012,68
7,10,99,92,BYU,7,2010,64
10,7,61,48,BYU,13,1991,64
4,13,71,40,Washington St.,31,2008,64
3,14,70,54,Washington St.,16,2007,64
4,5,61,41,Washington St.,20,2008,32
12,5,75,66,Col. of Charleston,9,1997,64
12,4,78,68,Wyoming,10,1987,32
11,6,73,66,Wyoming,7,2002,64
12,5,64,60,Wyoming,4,1987,64
4,13,73,49,Oklahoma St.,24,1995,64
3,11,75,67,Oklahoma St.,8,2000,32
4,1,71,66,Oklahoma St.,5,1995,16
3,14,67,54,Oklahoma St.,13,1991,64
4,2,68,54,Oklahoma St.,14,1995,8
4,5,66,52,Oklahoma St.,14,1995,32
8,9,77,75,Oklahoma St.,2,2009,64
3,10,68,66,Oklahoma St.,2,2000,16
3,14,86,66,Oklahoma St.,20,2000,64
6,11,77,63,Oklahoma St.,14,2003,64
3,6,73,64,Oklahoma St.,9,1991,32
2,15,63,50,Oklahoma St.,13,2005,64
5,12,74,62,Oklahoma St.,12,1993,64
2,7,85,77,Oklahoma St.,8,2005,32
4,13,65,55,Oklahoma St.,10,1994,64
9,8,69,61,Oklahoma St.,8,1999,64
2,7,70,53,Oklahoma St.,17,2004,32
2,15,75,56,Oklahoma St.,19,2004,64
2,1,64,62,Oklahoma St.,2,2004,8
2,3,63,51,Oklahoma St.,12,2004,16
8,9,74,59,Oklahoma St.,15,1998,64
2,10,87,71,Oklahoma St.,16,1992,32
2,15,100,73,Oklahoma St.,27,1992,64
12,5,61,57,Harvard,4,2014,64
14,3,68,62,Harvard,6,2013,64
12,5,75,63,Drexel,12,1996,64
9,8,70,66,UC Santa Barbara,4,1990,64
7,8,60,54,UConn,6,2014,2
7,1,63,53,UConn,10,2014,4
7,2,77,65,UConn,12,2014,32
2,10,75,63,UConn,12,1994,32
7,4,60,54,UConn,6,2014,8
2,15,78,67,UConn,11,2002,64
1,9,74,54,UConn,20,1990,32
2,15,93,85,UConn,8,1998,64
1,5,71,70,UConn,1,1990,16
2,11,75,74,UConn,1,1998,16
7,3,81,76,UConn,5,2014,16
2,11,71,59,UConn,12,2002,16
2,7,78,68,UConn,10,1998,32
7,10,89,81,UConn,8,2014,64
2,15,64,46,UConn,18,1994,64
2,7,77,74,UConn,3,2002,32
1,16,76,52,UConn,24,1990,64
3,14,81,52,UConn,29,2011,64
2,6,73,53,UConn,20,2004,16
3,4,56,55,UConn,1,2011,4
2,1,79,78,UConn,1,2004,4
5,12,75,67,UConn,8,2000,64
3,6,69,58,UConn,11,2011,32
2,3,82,73,UConn,9,2004,2
3,5,65,63,UConn,2,2011,8
3,8,53,41,UConn,12,2011,2
2,8,87,71,UConn,16,2004,8
2,7,72,55,UConn,17,2004,32
3,2,74,67,UConn,7,2011,16
2,7,96,91,UConn,5,1995,32
5,12,58,53,UConn,5,2003,64
2,3,99,89,UConn,10,1995,16
2,15,70,53,UConn,17,2004,64
2,15,100,71,UConn,29,1995,64
5,4,85,74,UConn,11,2003,32
11,14,66,50,UConn,16,1991,32
1,9,95,81,UConn,14,1996,32
1,16,68,59,UConn,9,1996,64
9,8,74,67,UConn,7,2016,64
11,6,79,62,UConn,17,1991,64
1,5,78,68,UConn,10,1999,16
1,8,87,83,UConn,4,2006,32
1,1,77,74,UConn,3,1999,2
1,10,67,62,UConn,5,1999,8
1,4,64,58,UConn,6,1999,4
1,16,103,47,UConn,56,2009,64
1,5,72,60,UConn,12,2009,16
1,5,98,92,UConn,6,2006,16
1,16,72,59,UConn,13,2006,64
2,15,77,71,UConn,6,2005,64
1,9,78,56,UConn,22,1999,32
1,16,91,66,UConn,25,1999,64
9,8,86,65,UConn,21,1992,64
1,3,82,75,UConn,7,2009,8
1,9,92,66,UConn,26,2009,32
7,10,68,65,Washington,3,2011,64
11,6,80,78,Washington,2,2010,64
1,8,97,79,Washington,18,2005,32
11,6,69,68,Washington,1,1998,64
1,16,88,77,Washington,11,2005,64
11,3,82,64,Washington,18,2010,32
11,14,81,66,Washington,15,1998,32
5,12,75,61,Washington,14,2006,64
5,4,67,64,Washington,3,2006,32
4,13,71,58,Washington,13,2009,64
11,6,86,84,South Ala.,2,1989,64
13,4,93,78,Southern U.,15,1993,64
12,5,75,60,Manhattan,15,2004,64
13,4,77,67,Manhattan,10,1995,64
12,5,61,57,Green Bay,4,1994,64
15,2,58,57,Hampton,1,2001,64
16,16,74,64,Hampton,10,2015,68
8,9,80,76,Seton Hall,4,2004,64
4,5,88,71,Seton Hall,17,1992,32
10,2,67,65,Seton Hall,2,2000,32
10,7,72,71,Seton Hall,1,2000,64
4,13,78,76,Seton Hall,2,1992,64
3,2,78,65,Seton Hall,13,1989,16
3,11,87,73,Seton Hall,14,1989,32
3,14,60,51,Seton Hall,9,1989,64
3,2,95,78,Seton Hall,17,1989,4
3,4,84,61,Seton Hall,23,1989,8
2,15,81,59,Seton Hall,22,1993,64
3,14,71,51,Seton Hall,20,1991,64
8,9,80,64,Seton Hall,16,1988,64
3,11,81,69,Seton Hall,12,1991,32
3,2,81,77,Seton Hall,4,1991,16
11,6,90,80,Penn,10,1994,64
11,3,77,75,Southern Ill.,2,2002,32
11,6,76,68,Southern Ill.,8,2002,64
7,10,65,56,Southern Ill.,9,2005,64
4,13,61,51,Southern Ill.,10,2007,64
4,5,63,48,Southern Ill.,15,2007,32
3,14,69,60,Oklahoma,9,2015,64
6,11,72,64,Oklahoma,8,2008,64
1,12,65,54,Oklahoma,11,2003,16
3,11,72,66,Oklahoma,6,2015,32
1,8,74,65,Oklahoma,9,2003,32
4,13,80,74,Oklahoma,6,1986,64
1,16,71,54,Oklahoma,17,2003,64
1,16,77,68,Oklahoma,9,1990,64
13,4,61,60,Oklahoma,1,1999,64
2,15,82,54,Oklahoma,28,2009,64
2,10,73,63,Oklahoma,10,2009,32
13,5,85,72,Oklahoma,13,1999,32
2,3,84,71,Oklahoma,13,2009,16
1,8,107,87,Oklahoma,20,1988,32
1,5,108,98,Oklahoma,10,1988,16
1,6,78,59,Oklahoma,19,1988,8
1,16,94,66,Oklahoma,28,1988,64
1,1,86,78,Oklahoma,8,1988,4
1,5,86,84,Oklahoma,2,1985,16
1,9,75,69,Oklahoma,6,1985,32
3,14,84,67,Oklahoma,17,2005,64
1,16,96,83,Oklahoma,13,1985,64
2,3,77,63,Oklahoma,14,2016,16
2,1,80,68,Oklahoma,12,2016,8
2,3,88,67,Oklahoma,21,2002,16
2,10,85,81,Oklahoma,4,2016,32
2,7,78,65,Oklahoma,13,2002,32
6,11,74,69,Oklahoma,5,1987,64
1,16,72,71,Oklahoma,1,1989,64
1,9,124,81,Oklahoma,43,1989,32
2,15,82,68,Oklahoma,14,2016,64
2,12,81,75,Oklahoma,6,2002,8
6,3,96,93,Oklahoma,3,1987,32
2,15,71,63,Oklahoma,8,2002,64
3,14,74,50,Oklahoma,24,2000,64
14,3,62,61,Richmond,1,1998,64
13,5,59,55,Richmond,4,1988,32
13,4,72,69,Richmond,3,1988,64
15,2,73,69,Richmond,4,1991,64
12,5,69,66,Richmond,3,2011,64
12,13,65,48,Richmond,17,2011,32
13,4,70,69,San Diego,1,2008,64
12,5,85,83,Little Rock,2,2016,64
14,3,90,83,Little Rock,7,1986,64
5,12,77,60,Southern California,17,2007,64
6,11,69,54,Southern California,15,2001,64
6,3,74,71,Southern California,3,2001,32
11,6,66,65,Southern California,1,2017,64
6,2,80,76,Southern California,4,2001,16
11,11,75,71,Southern California,4,2017,68
5,4,87,68,Southern California,19,2007,32
2,15,84,54,Southern California,30,1992,64
10,7,72,55,Southern California,17,2009,64
14,3,83,79,Cleveland St.,4,1986,64
14,6,75,69,Cleveland St.,6,1986,32
13,4,84,69,Cleveland St.,15,2009,64
2,6,71,54,Cincinnati,17,1993,16
4,13,80,77,Cincinnati,3,2004,64
6,3,62,56,Cincinnati,6,2012,32
6,11,65,59,Cincinnati,6,2012,64
3,14,72,48,Cincinnati,24,1999,64
2,7,92,55,Cincinnati,37,1993,32
2,15,93,66,Cincinnati,27,1993,64
2,15,64,47,Cincinnati,17,2000,64
5,12,84,59,Cincinnati,25,2001,64
7,10,77,71,Cincinnati,6,1995,64
2,15,65,62,Cincinnati,3,1998,64
6,11,78,63,Cincinnati,15,2011,64
5,13,66,43,Cincinnati,23,2001,32
7,10,76,64,Cincinnati,12,2005,64
8,9,66,65,Cincinnati,1,2015,64
3,14,86,69,Cincinnati,17,1997,64
4,6,88,57,Cincinnati,31,1992,8
4,5,77,65,Cincinnati,12,1992,32
2,15,66,61,Cincinnati,5,1996,64
2,3,87,70,Cincinnati,17,1996,16
4,13,85,47,Cincinnati,38,1992,64
2,7,78,65,Cincinnati,13,1996,32
4,9,69,67,Cincinnati,2,1992,16
1,16,90,52,Cincinnati,38,2002,64
6,11,75,61,Cincinnati,14,2017,64
8,9,58,57,Creighton,1,2012,64
12,5,83,82,Creighton,1,2002,64
7,10,67,63,Creighton,4,2013,64
10,7,62,58,Creighton,4,1999,64
3,14,76,66,Creighton,10,2014,64
11,6,64,56,Creighton,8,1991,64
1,16,75,46,Ohio St.,29,2011,64
1,8,98,66,Ohio St.,32,2011,32
2,7,73,66,Ohio St.,7,2012,32
2,15,78,59,Ohio St.,19,2012,64
2,6,81,66,Ohio St.,15,2012,16
2,1,77,70,Ohio St.,7,2012,8
1,2,92,76,Ohio St.,16,2007,8
1,9,78,71,Ohio St.,7,2007,32
9,8,91,77,Ohio St.,14,1987,64
3,14,87,61,Ohio St.,26,2000,64
1,5,85,84,Ohio St.,1,2007,16
1,2,67,60,Ohio St.,7,2007,4
1,16,78,57,Ohio St.,21,2007,64
4,3,77,74,Ohio St.,3,1999,8
4,12,75,44,Ohio St.,31,1999,32
2,10,75,66,Ohio St.,9,2010,32
4,13,75,64,Ohio St.,11,1985,64
1,8,65,61,Ohio St.,4,1991,32
4,1,72,64,Ohio St.,8,1999,16
4,13,72,58,Ohio St.,14,1999,64
2,15,68,51,Ohio St.,17,2010,64
2,15,70,62,Ohio St.,8,2006,64
1,16,97,86,Ohio St.,11,1991,64
1,16,83,56,Ohio St.,27,1992,64
1,4,80,73,Ohio St.,7,1992,16
8,9,84,83,Ohio St.,1,1990,64
4,13,69,64,Ohio St.,5,2002,64
2,6,73,70,Ohio St.,3,2013,16
1,9,78,55,Ohio St.,23,1992,32
2,10,78,75,Ohio St.,3,2013,32
2,15,95,70,Ohio St.,25,2013,64
10,7,75,72,Ohio St.,3,2015,64
12,5,79,75,Yale,4,2016,64
7,10,81,61,Butler,20,2008,64
12,5,47,46,Butler,1,2003,64
6,11,68,56,Butler,12,2013,64
12,4,79,71,Butler,8,2003,32
9,8,71,61,Butler,10,2016,64
10,7,79,63,Butler,16,2001,64
8,4,61,54,Butler,7,2011,16
5,4,62,59,Butler,3,2007,32
8,2,74,71,Butler,3,2011,8
5,12,57,46,Butler,11,2007,64
8,9,60,58,Butler,2,2011,64
6,11,56,48,Butler,8,2015,64
8,11,70,62,Butler,8,2011,4
8,1,71,70,Butler,1,2011,32
4,12,74,65,Butler,9,2017,32
5,12,77,59,Butler,18,2010,64
5,2,63,56,Butler,7,2010,8
5,5,52,50,Butler,2,2010,4
5,1,63,59,Butler,4,2010,16
4,13,76,64,Butler,12,2017,64
5,13,54,52,Butler,2,2010,32
6,11,67,59,Georgia,8,1985,64
3,14,85,68,Georgia,17,2002,64
8,9,81,74,Georgia,7,1996,64
8,1,76,69,Georgia,7,1996,32
7,10,77,54,Gonzaga,23,2012,64
3,14,74,64,Gonzaga,10,2005,64
11,6,68,52,Gonzaga,16,2016,64
1,8,79,73,Gonzaga,6,2017,32
3,14,79,75,Gonzaga,4,2006,64
2,7,87,68,Gonzaga,19,2015,32
1,4,61,58,Gonzaga,3,2017,16
2,15,86,76,Gonzaga,10,2015,64
4,12,83,81,Gonzaga,2,2009,32
2,11,74,62,Gonzaga,12,2015,16
11,3,82,59,Gonzaga,23,2016,32
4,13,77,64,Gonzaga,13,2009,64
1,7,77,73,Gonzaga,4,2017,4
3,6,90,80,Gonzaga,10,2006,32
1,16,66,46,Gonzaga,20,2017,64
1,11,83,59,Gonzaga,24,2017,8
11,6,86,71,Gonzaga,15,2011,64
12,13,85,68,Gonzaga,17,2001,32
2,15,76,49,Gonzaga,27,2004,64
9,8,74,69,Gonzaga,5,2003,64
10,6,73,72,Gonzaga,1,1999,16
10,2,82,76,Gonzaga,6,2000,32
12,5,86,85,Gonzaga,1,2001,64
10,7,75,63,Gonzaga,12,1999,64
10,2,82,74,Gonzaga,8,1999,32
8,9,67,60,Gonzaga,7,2010,64
1,16,64,58,Gonzaga,6,2013,64
8,9,85,77,Gonzaga,8,2014,64
10,7,77,66,Gonzaga,11,2000,64
9,8,82,70,Fresno St.,12,2001,64
16,16,92,84,UNC Asheville,8,2003,68
16,16,81,77,UNC Asheville,4,2011,68
5,12,78,54,Louisiana Tech,24,1985,64
5,4,79,67,Louisiana Tech,12,1985,32
9,8,83,74,Louisiana Tech,9,1989,64
2,15,85,52,Mississippi St.,33,2004,64
5,4,78,64,Mississippi St.,14,1995,32
5,12,75,67,Mississippi St.,8,1995,64
3,14,70,58,Mississippi St.,12,2002,64
5,13,63,41,Mississippi St.,22,1996,32
5,12,58,51,Mississippi St.,7,1996,64
9,8,93,70,Mississippi St.,23,2005,64
5,2,73,63,Mississippi St.,10,1996,8
5,1,60,55,Mississippi St.,5,1996,16
8,9,76,69,Mississippi St.,7,2008,64
10,7,70,68,Stanford,2,1995,64
9,8,66,58,Stanford,8,1996,64
1,16,71,45,Stanford,26,2004,64
1,16,89,60,Stanford,29,2001,64
10,2,60,57,Stanford,3,2014,32
8,9,84,68,Stanford,16,2002,64
4,13,77,69,Stanford,8,2003,64
1,5,78,65,Stanford,13,2001,16
1,9,90,83,Stanford,7,2001,32
1,16,84,65,Stanford,19,2000,64
10,7,58,53,Stanford,5,2014,64
3,11,83,65,Stanford,18,1998,32
3,14,77,53,Stanford,24,2008,64
3,2,67,59,Stanford,8,1998,16
3,14,67,57,Stanford,10,1998,64
3,8,79,77,Stanford,2,1998,8
3,6,82,81,Stanford,1,2008,32
2,15,69,57,Stanford,12,1999,64
6,3,72,66,Stanford,6,1997,32
6,11,80,67,Stanford,13,1997,64
10,7,76,74,Iowa St.,2,1992,64
3,6,85,83,Iowa St.,2,2014,32
3,14,93,75,Iowa St.,18,2014,64
4,13,94,81,Iowa St.,13,2016,64
7,10,81,79,Iowa St.,2,1986,64
4,12,78,61,Iowa St.,17,2016,32
7,2,72,69,Iowa St.,3,1986,32
5,12,74,64,Iowa St.,10,1996,64
6,3,67,66,Iowa St.,1,1997,32
2,15,88,78,Iowa St.,10,2000,64
8,9,77,64,Iowa St.,13,2012,64
5,12,84,73,Iowa St.,11,2017,64
6,11,69,57,Iowa St.,12,1997,64
2,6,80,56,Iowa St.,24,2000,16
2,7,79,60,Iowa St.,19,2000,32
7,10,64,61,Iowa St.,3,1995,64
9,8,64,53,Iowa St.,11,2005,64
10,7,76,58,Iowa St.,18,2013,64
7,10,69,56,Iowa,13,2001,64
9,8,98,92,Iowa,6,1992,64
4,13,87,73,Iowa,14,1989,64
7,10,83,52,Iowa,31,2015,64
4,13,82,69,Iowa,13,1993,64
7,10,76,73,Iowa,3,1991,64
7,10,72,70,Iowa,2,2016,64
5,12,102,98,Iowa,4,1988,64
2,15,99,76,Iowa,23,1987,64
2,7,84,82,Iowa,2,1987,32
8,9,73,60,Iowa,13,1997,64
5,12,77,64,Iowa,13,1999,64
6,11,81,79,Iowa,2,1996,64
2,6,93,91,Iowa,2,1987,16
5,4,104,86,Iowa,18,1988,32
5,4,82,72,Iowa,10,1999,32
1,16,83,62,Indiana,21,2013,64
5,4,73,67,Indiana,6,2016,32
5,12,99,74,Indiana,25,2016,64
5,4,67,58,Indiana,9,1994,32
1,9,58,52,Indiana,6,2013,32
5,12,84,72,Indiana,12,1994,64
7,10,94,87,Indiana,7,1998,64
2,7,89,79,Indiana,10,1992,32
6,11,87,83,Indiana,4,2006,64
2,15,99,85,Indiana,14,1989,64
2,15,79,69,Indiana,10,1991,64
2,1,106,79,Indiana,27,1992,8
2,7,92,69,Indiana,23,1989,32
1,9,73,70,Indiana,3,1993,32
2,15,94,55,Indiana,39,1992,64
1,4,82,69,Indiana,13,1993,16
1,16,97,54,Indiana,43,1993,64
2,3,85,74,Indiana,11,1992,16
2,7,82,60,Indiana,22,1991,32
5,10,81,69,Indiana,12,2002,8
5,1,74,73,Indiana,1,2002,16
5,2,73,64,Indiana,9,2002,4
1,10,77,76,Indiana,1,1987,8
7,10,67,62,Indiana,5,2003,64
6,11,108,88,Indiana,20,1999,64
4,13,79,66,Indiana,13,2012,64
1,16,92,58,Indiana,34,1987,64
1,8,107,90,Indiana,17,1987,32
1,1,97,93,Indiana,4,1987,4
4,12,63,61,Indiana,2,2012,32
5,12,75,56,Indiana,19,2002,64
1,2,74,73,Indiana,1,1987,2
1,5,88,82,Indiana,6,1987,16
5,13,76,67,Indiana,9,2002,32
7,10,70,57,Indiana,13,2007,64
8,9,81,77,Kansas,4,2000,64
2,15,79,71,Kansas,8,1990,64
3,1,79,73,Kansas,6,1991,4
1,8,75,61,Kansas,14,1997,32
3,14,55,49,Kansas,6,1991,64
3,2,83,65,Kansas,18,1991,16
2,7,90,76,Kansas,14,1993,32
1,2,104,86,Kansas,18,2002,8
1,12,72,57,Kansas,15,2008,16
1,8,86,63,Kansas,23,2002,32
1,10,59,57,Kansas,2,2008,8
2,15,65,50,Kansas,15,2012,64
1,6,75,67,Kansas,8,1986,8
1,16,78,64,Kansas,14,1997,64
1,1,75,68,Kansas,7,2008,2
5,12,66,55,Kansas,11,1987,64
3,6,77,66,Kansas,11,1991,32
1,8,75,56,Kansas,19,2008,32
4,5,69,58,Kansas,11,1994,32
6,11,85,72,Kansas,13,1988,64
6,1,83,79,Kansas,4,1988,2
2,10,63,60,Kansas,3,2012,32
3,1,93,81,Kansas,12,1991,8
6,4,71,58,Kansas,13,1988,8
1,16,71,46,Kansas,25,1986,64
2,2,64,62,Kansas,2,2012,4
6,2,66,59,Kansas,7,1988,4
4,13,102,73,Kansas,29,1994,64
2,1,83,77,Kansas,6,1993,8
2,15,80,69,Kansas,11,2014,64
1,4,73,69,Kansas,4,2002,16
1,1,84,66,Kansas,18,2008,4
5,13,67,63,Kansas,4,1987,32
1,16,70,59,Kansas,11,2002,64
6,14,61,58,Kansas,3,1988,32
2,6,93,76,Kansas,17,1993,16
1,8,70,58,Kansas,12,2013,32
2,1,80,67,Kansas,13,2012,8
2,11,60,57,Kansas,3,2012,16
1,16,64,57,Kansas,7,2013,64
6,11,95,74,Kansas,21,1999,64
1,9,65,43,Kansas,22,1986,32
1,5,96,86,Kansas,10,1986,16
2,15,94,72,Kansas,22,1993,64
1,16,85,61,Kansas,24,2008,64
6,7,77,64,Kansas,13,1988,16
1,16,110,52,Kansas,58,1998,64
4,13,99,75,Kansas,24,2001,64
2,15,75,56,Kansas,19,2015,64
3,11,60,43,Kansas,17,2009,32
1,8,75,70,Kansas,5,1995,32
1,16,90,74,Kansas,16,2010,64
4,5,87,58,Kansas,29,2001,32
1,16,82,68,Kansas,14,1995,64
1,16,100,62,Kansas,38,2017,64
1,9,90,70,Kansas,20,2017,32
3,14,84,74,Kansas,10,2009,64
1,5,79,63,Kansas,16,2016,16
1,9,73,61,Kansas,12,2016,32
1,4,98,66,Kansas,32,2017,16
1,16,100,67,Kansas,33,1992,64
1,16,105,79,Kansas,26,2016,64
2,10,108,76,Kansas,32,2003,32
2,15,64,61,Kansas,3,2003,64
3,14,49,38,Kansas,11,1985,64
2,10,76,51,Kansas,25,1996,32
2,1,78,75,Kansas,3,2003,8
4,13,78,53,Kansas,25,2004,64
1,16,107,67,Kansas,40,2007,64
1,12,77,57,Kansas,20,2011,16
1,4,61,58,Kansas,3,2007,16
1,8,88,76,Kansas,12,2007,32
4,9,100,74,Kansas,26,2004,16
2,15,92,54,Kansas,38,1996,64
2,3,69,65,Kansas,4,2003,16
4,12,78,63,Kansas,15,2004,32
1,16,72,53,Kansas,19,2011,64
2,3,83,80,Kansas,3,1996,16
1,9,73,59,Kansas,14,2011,32
2,3,94,61,Kansas,33,2003,4
8,9,72,64,Old Dominion,8,1986,64
14,3,89,81,Old Dominion,8,1995,64
11,6,51,50,Old Dominion,1,2010,64
7,10,83,75,SMU,8,1988,64
5,12,85,68,SMU,17,1985,64
16,16,81,69,Cal Poly,12,2014,68
5,12,71,54,UNI,17,2015,64
14,3,74,71,UNI,3,1990,64
9,1,69,67,UNI,2,2010,32
9,8,69,66,UNI,3,2010,64
11,6,75,72,UNI,3,2016,64
12,4,83,75,Milwaukee,8,2005,32
12,5,83,73,Milwaukee,10,2005,64
11,6,82,74,Milwaukee,8,2006,64
1,4,60,55,Pittsburgh,5,2009,16
1,16,72,62,Pittsburgh,10,2009,64
1,8,84,76,Pittsburgh,8,2009,32
9,8,77,48,Pittsburgh,29,2014,64
5,12,79,64,Pittsburgh,15,2006,64
6,11,76,68,Pittsburgh,8,1991,64
2,15,108,90,Pittsburgh,18,1988,64
2,7,74,52,Pittsburgh,22,2003,32
4,13,82,63,Pittsburgh,19,2008,64
1,16,74,51,Pittsburgh,23,2011,64
3,6,59,55,Pittsburgh,4,2004,32
3,14,71,54,Pittsburgh,17,2002,64
2,15,87,61,Pittsburgh,26,2003,64
3,6,63,50,Pittsburgh,13,2002,32
3,14,53,44,Pittsburgh,9,2004,64
3,14,93,68,Pittsburgh,25,1987,64
3,14,89,66,Pittsburgh,23,2010,64
3,14,79,58,Pittsburgh,21,2007,64
3,11,84,79,Pittsburgh,5,2007,32
11,6,50,49,Georgia St.,1,2001,64
14,3,57,56,Georgia St.,1,2015,64
8,9,61,57,George Mason,4,2011,64
11,3,65,60,George Mason,5,2006,32
11,1,86,84,George Mason,2,2006,8
11,7,63,55,George Mason,8,2006,16
11,6,75,65,George Mason,10,2006,64
4,5,70,57,Loyola Chicago,13,1985,32
4,13,59,58,Loyola Chicago,1,1985,64
16,16,72,57,Florida A&M,15,2004,68
10,7,59,58,Miami (OH),1,1999,64
10,2,66,58,Miami (OH),8,1999,32
12,5,71,62,Miami (OH),9,1995,64
9,8,82,81,Illinois St.,1,1998,64
9,8,58,55,Illinois St.,3,1985,64
13,4,93,89,UNCW,4,2002,64
7,2,78,65,Wichita St.,13,2015,32
11,6,65,55,Wichita St.,10,2016,64
7,10,81,76,Wichita St.,5,2015,64
11,11,70,50,Wichita St.,20,2016,68
1,16,64,37,Wichita St.,27,2014,64
9,8,73,55,Wichita St.,18,2013,64
9,13,72,58,Wichita St.,14,2013,16
7,2,80,73,Wichita St.,7,2006,32
7,10,86,66,Wichita St.,20,2006,64
9,1,76,70,Wichita St.,6,2013,32
10,7,64,58,Wichita St.,6,2017,64
9,2,70,66,Wichita St.,4,2013,8
15,2,86,84,Norfolk St.,2,2012,64
4,1,61,59,Michigan St.,2,2014,16
4,12,80,73,Michigan St.,7,2014,32
7,2,60,54,Michigan St.,6,2015,32
7,3,62,58,Michigan St.,4,2015,16
7,4,76,70,Michigan St.,6,2015,8
9,8,61,49,Michigan St.,12,2007,64
4,5,63,56,Michigan St.,7,1998,32
4,13,83,71,Michigan St.,12,1998,64
4,13,93,78,Michigan St.,15,2014,64
7,10,70,63,Michigan St.,7,2015,64
5,4,80,68,Michigan St.,12,1986,32
7,10,79,64,Michigan St.,15,2003,64
7,10,84,73,Michigan St.,11,1994,64
7,6,60,58,Michigan St.,2,2003,16
1,13,54,46,Michigan St.,8,1999,16
1,16,76,53,Michigan St.,23,1999,64
1,3,73,66,Michigan St.,7,1999,8
5,12,72,70,Michigan St.,2,1986,64
1,9,74,66,Michigan St.,8,1999,32
7,2,68,46,Michigan St.,22,2003,32
1,8,53,41,Michigan St.,12,2000,4
1,2,75,64,Michigan St.,11,2000,8
5,12,89,81,Michigan St.,8,2005,64
5,2,94,88,Michigan St.,6,2005,8
5,6,70,69,Michigan St.,1,2010,8
5,13,72,61,Michigan St.,11,2005,32
5,4,85,83,Michigan St.,2,2010,32
5,1,78,68,Michigan St.,10,2005,16
1,9,62,58,Michigan St.,4,1990,32
5,12,70,67,Michigan St.,3,2010,64
2,15,77,62,Michigan St.,15,2009,64
3,6,70,48,Michigan St.,22,2013,32
2,10,74,69,Michigan St.,5,2009,32
5,4,65,54,Michigan St.,11,2008,32
1,16,75,71,Michigan St.,4,1990,64
5,12,72,61,Michigan St.,11,2008,64
1,4,75,58,Michigan St.,17,2000,16
1,8,73,61,Michigan St.,12,2000,32
2,3,67,62,Michigan St.,5,2009,16
2,1,64,52,Michigan St.,12,2009,8
1,16,65,38,Michigan St.,27,2000,64
5,12,61,54,Michigan St.,7,1992,64
2,1,82,73,Michigan St.,9,2009,4
5,9,59,52,Michigan St.,7,2010,16
9,8,78,58,Michigan St.,20,2017,64
1,5,89,76,Michigan St.,13,2000,2
3,14,65,54,Michigan St.,11,2013,64
1,9,65,61,Michigan St.,4,2012,32
1,11,69,62,Michigan St.,7,2001,8
1,12,77,62,Michigan St.,15,2001,16
1,16,89,67,Michigan St.,22,2012,64
1,9,81,65,Michigan St.,16,2001,32
5,12,60,58,Michigan St.,2,1991,64
1,16,69,35,Michigan St.,34,2001,64
13,4,77,66,Hawaii,11,2016,64
1,9,82,49,Arizona,33,1998,32
3,2,79,78,Arizona,1,2005,16
4,13,65,57,Arizona,8,1997,64
1,16,94,60,Arizona,34,1989,64
4,1,66,58,Arizona,8,1997,4
3,11,85,63,Arizona,22,2005,32
2,7,69,60,Arizona,9,2017,32
2,15,100,82,Arizona,18,2017,64
5,12,77,75,Arizona,2,2011,64
4,10,96,92,Arizona,4,1997,8
4,12,73,69,Arizona,4,1997,32
1,16,99,60,Arizona,39,1998,64
4,1,84,79,Arizona,5,1997,2
5,4,70,69,Arizona,1,2011,32
4,1,85,82,Arizona,3,1997,16
1,4,87,79,Arizona,8,1998,16
1,9,94,68,Arizona,26,1989,32
5,1,93,77,Arizona,16,2011,16
3,14,66,53,Arizona,13,2005,64
12,5,84,71,Arizona,13,2009,64
2,1,87,81,Arizona,6,2001,8
2,15,101,76,Arizona,25,2001,64
8,9,94,75,Arizona,19,2006,64
2,10,73,52,Arizona,21,2001,32
2,3,66,56,Arizona,10,2001,16
12,13,71,57,Arizona,14,2009,32
2,1,80,61,Arizona,19,2001,4
1,9,96,95,Arizona,1,2003,32
2,7,71,58,Arizona,13,1994,32
3,14,86,81,Arizona,5,2002,64
1,5,88,71,Arizona,17,2003,16
1,5,99,79,Arizona,20,1988,16
2,1,92,72,Arizona,20,1994,8
1,4,70,64,Arizona,6,2014,16
2,10,76,61,Arizona,15,1991,32
2,15,81,55,Arizona,26,1994,64
6,11,81,64,Arizona,17,2013,64
1,2,70,52,Arizona,18,1988,8
6,14,74,51,Arizona,23,2013,32
1,16,68,59,Arizona,9,2014,64
2,15,93,80,Arizona,13,1991,64
1,16,71,47,Arizona,24,2000,64
1,16,90,50,Arizona,40,1988,64
3,14,90,51,Arizona,39,1996,64
2,6,68,60,Arizona,8,2015,16
1,8,84,55,Arizona,29,1988,32
2,10,73,58,Arizona,15,2015,32
1,8,84,61,Arizona,23,2014,32
1,16,80,51,Arizona,29,2003,64
3,6,87,73,Arizona,14,1996,32
2,15,93,72,Arizona,21,2015,64
2,15,79,67,Arizona,12,1990,64
2,3,82,70,Arizona,12,1994,16
3,11,68,60,Arizona,8,2002,32
10,2,74,70,Davidson,4,2008,32
10,3,73,56,Davidson,17,2008,16
10,7,82,76,Davidson,6,2008,64
4,12,87,82,Kentucky,5,2002,32
4,5,71,63,Kentucky,8,2011,32
4,13,83,68,Kentucky,15,2002,64
2,7,92,79,Kentucky,13,2001,32
2,10,106,98,Kentucky,8,1992,32
2,15,72,68,Kentucky,4,2001,64
4,13,85,57,Kentucky,28,2016,64
1,12,62,45,Kentucky,17,2010,16
1,9,90,60,Kentucky,30,2010,32
4,2,76,69,Kentucky,7,2011,8
2,3,87,77,Kentucky,10,1992,16
4,13,59,57,Kentucky,2,2011,64
4,1,62,60,Kentucky,2,2011,16
1,16,100,71,Kentucky,29,2010,64
2,15,88,69,Kentucky,19,1992,64
1,4,76,67,Kentucky,9,1996,2
12,5,66,58,Kentucky,8,1985,64
12,4,64,61,Kentucky,3,1985,32
1,1,81,74,Kentucky,7,1996,4
1,4,101,70,Kentucky,31,1996,16
1,2,83,63,Kentucky,20,1996,8
3,14,83,70,Kentucky,13,1994,64
3,10,58,43,Kentucky,15,1999,16
1,16,110,72,Kentucky,38,1996,64
3,6,92,88,Kentucky,4,1999,32
1,9,84,60,Kentucky,24,1996,32
3,14,82,60,Kentucky,22,1999,64
1,9,74,54,Kentucky,20,2003,32
2,15,99,84,Kentucky,15,1988,64
2,7,69,60,Kentucky,9,2005,32
2,15,72,64,Kentucky,8,2005,64
1,8,83,62,Kentucky,21,1993,32
2,6,62,52,Kentucky,10,2005,16
1,16,79,56,Kentucky,23,2015,64
8,2,75,72,Kentucky,3,2014,8
1,16,81,66,Kentucky,15,2012,64
2,7,90,81,Kentucky,9,1988,32
8,4,74,69,Kentucky,5,2014,16
5,12,85,80,Kentucky,5,2000,64
1,16,75,55,Kentucky,20,1986,64
1,4,102,90,Kentucky,12,2012,16
1,8,87,71,Kentucky,16,2012,32
1,5,63,57,Kentucky,6,2003,16
1,16,96,52,Kentucky,44,1993,64
1,16,95,64,Kentucky,31,2003,64
1,2,67,59,Kentucky,8,2012,2
1,5,78,39,Kentucky,39,2015,16
1,5,68,63,Kentucky,5,1986,16
1,3,106,81,Kentucky,25,1993,8
1,3,82,70,Kentucky,12,2012,8
8,1,78,76,Kentucky,2,2014,32
1,8,64,51,Kentucky,13,2015,32
1,5,103,69,Kentucky,34,1993,16
8,2,74,73,Kentucky,1,2014,4
1,3,68,66,Kentucky,2,2015,8
8,9,56,49,Kentucky,7,2014,64
1,4,69,61,Kentucky,8,2012,4
1,8,71,64,Kentucky,7,1986,32
8,9,67,58,Kentucky,9,2007,64
1,16,92,54,Kentucky,38,1997,64
1,16,96,76,Kentucky,20,2004,64
8,9,69,64,Kentucky,5,2006,64
1,2,72,59,Kentucky,13,1997,8
1,1,78,69,Kentucky,9,1997,4
2,10,88,61,Kentucky,27,1998,32
2,3,78,69,Kentucky,9,1998,2
1,5,97,73,Kentucky,24,1995,16
2,3,86,85,Kentucky,1,1998,4
1,4,83,68,Kentucky,15,1997,16
2,15,79,70,Kentucky,9,2017,64
1,9,82,60,Kentucky,22,1995,32
2,10,65,62,Kentucky,3,2017,32
2,3,86,75,Kentucky,11,2017,16
2,6,94,68,Kentucky,26,1998,16
2,1,86,84,Kentucky,2,1998,8
2,15,82,67,Kentucky,15,1998,64
1,16,113,67,Kentucky,46,1995,64
1,8,75,69,Kentucky,6,1997,32
4,13,101,91,Villanova,10,1997,64
2,15,73,53,Villanova,20,2014,64
3,6,89,69,Villanova,20,2009,32
9,8,50,48,Villanova,2,1991,64
1,16,93,52,Villanova,41,2015,64
1,16,76,56,Villanova,20,2017,64
3,14,80,67,Villanova,13,2009,64
3,2,77,54,Villanova,23,2009,16
3,1,78,76,Villanova,2,2009,8
2,15,73,70,Villanova,3,2010,64
12,5,75,69,Villanova,6,2008,64
12,13,84,72,Villanova,12,2008,32
3,14,92,58,Villanova,34,1996,64
2,3,92,69,Villanova,23,2016,16
2,2,95,51,Villanova,44,2016,4
6,11,82,74,Villanova,8,1988,64
1,8,82,78,Villanova,4,2006,32
1,16,58,45,Villanova,13,2006,64
6,2,80,74,Villanova,6,1988,16
2,7,87,68,Villanova,19,2016,32
1,4,60,59,Villanova,1,2006,16
6,3,66,63,Villanova,3,1988,32
10,7,71,62,Villanova,9,1986,64
2,1,64,59,Villanova,5,2016,8
2,15,86,56,Villanova,30,2016,64
2,1,77,74,Villanova,3,2016,2
8,2,56,44,Villanova,12,1985,8
8,5,46,43,Villanova,3,1985,16
5,12,55,47,Villanova,8,2005,64
5,4,76,65,Villanova,11,2005,32
8,1,66,64,Villanova,2,1985,2
8,9,51,49,Villanova,2,1985,64
8,1,59,55,Villanova,4,1985,32
8,2,52,45,Villanova,7,1985,4
14,3,79,72,Weber St.,7,1995,64
14,3,76,74,Weber St.,2,1999,64
8,9,70,64,Kansas St.,6,2012,64
4,13,66,53,Kansas St.,13,1988,64
4,1,73,70,Kansas St.,3,1988,16
4,5,66,58,Kansas St.,8,1988,32
11,6,80,67,Kansas St.,13,2008,64
5,12,73,68,Kansas St.,5,2011,64
9,8,82,79,Kansas St.,3,1987,64
2,15,82,62,Kansas St.,20,2010,64
11,11,95,88,Kansas St.,7,2017,68
2,7,84,72,Kansas St.,12,2010,32
2,6,101,96,Kansas St.,5,2010,16
8,9,68,66,Northwestern,2,2017,64
8,1,71,68,NC State,3,2015,32
10,7,58,52,NC State,6,2006,64
6,11,114,85,NC State,29,1991,64
5,12,81,66,NC State,15,1989,64
7,10,69,58,NC State,11,2002,64
8,9,66,65,NC State,1,2015,64
5,4,102,96,NC State,6,1989,32
6,11,66,64,NC State,2,1986,64
6,14,80,66,NC State,14,1986,32
11,6,79,65,NC State,14,2012,64
11,3,66,63,NC State,3,2012,32
3,14,61,52,NC State,9,2004,64
3,14,65,56,NC State,9,1985,64
3,7,61,55,NC State,6,1985,16
6,7,70,66,NC State,4,1986,16
3,11,86,73,NC State,13,1985,32
12,12,74,59,NC State,15,2014,68
10,7,75,63,NC State,12,2005,64
10,2,65,62,NC State,3,2005,32
9,8,64,61,Saint Louis,3,1995,64
5,12,83,80,Saint Louis,3,2014,64
4,13,64,44,Saint Louis,20,2013,64
10,7,51,46,Saint Louis,5,1998,64
9,8,61,54,Saint Louis,7,2012,64
9,8,80,62,Colorado,18,1997,64
11,6,68,64,Colorado,4,2012,64
9,8,68,64,Ball St.,4,1989,64
12,5,54,53,Ball St.,1,1990,64
12,4,62,60,Ball St.,2,1990,32
4,13,68,62,Louisville,6,2005,64
3,2,79,60,Louisville,19,2008,16
3,6,78,48,Louisville,30,2008,32
4,5,76,54,Louisville,22,2005,32
4,1,93,79,Louisville,14,2005,16
4,8,75,65,Louisville,10,2015,16
4,13,86,64,Louisville,22,2003,64
4,7,93,85,Louisville,8,2005,8
6,3,64,63,Louisville,1,1997,32
4,13,57,55,Louisville,2,2015,64
3,14,79,61,Louisville,18,2008,64
4,5,66,53,Louisville,13,2015,32
6,11,65,57,Louisville,8,1997,64
6,10,78,63,Louisville,15,1997,16
4,13,76,70,Louisville,6,1993,64
4,5,78,63,Louisville,15,1993,32
8,9,81,58,Louisville,23,1992,64
6,3,68,64,Louisville,4,1996,32
6,11,78,58,Louisville,20,2007,64
6,11,82,80,Louisville,2,1996,64
1,2,85,63,Louisville,22,2013,8
2,15,78,63,Louisville,15,2017,64
5,4,97,76,Louisville,21,1988,32
4,13,71,64,Louisville,7,2014,64
1,4,82,76,Louisville,6,2013,2
4,5,93,84,Louisville,9,1989,32
4,5,66,51,Louisville,15,2014,32
1,8,82,56,Louisville,26,2013,32
1,9,72,68,Louisville,4,2013,4
5,12,70,61,Louisville,9,1988,64
1,9,79,72,Louisville,7,2009,32
1,16,74,54,Louisville,20,2009,64
1,12,77,69,Louisville,8,2013,16
4,13,76,71,Louisville,5,1989,64
1,12,103,64,Louisville,39,2009,16
1,16,79,48,Louisville,31,2013,64
2,8,84,76,Louisville,8,1986,8
4,7,72,68,Louisville,4,2012,8
4,5,59,56,Louisville,3,2012,32
2,11,88,77,Louisville,11,1986,4
2,3,94,79,Louisville,15,1986,16
2,7,82,68,Louisville,14,1986,32
4,13,69,62,Louisville,7,2012,64
3,6,60,55,Louisville,5,1994,32
3,14,67,58,Louisville,9,1994,64
4,1,57,44,Louisville,13,2012,16
2,15,93,73,Louisville,20,1986,64
2,1,72,69,Louisville,3,1986,2
4,13,78,59,Louisville,19,1990,64
2,15,79,67,Virginia,12,2015,64
1,16,70,59,Virginia,11,2014,64
6,3,71,56,Virginia,15,1993,32
6,11,78,66,Virginia,12,1993,64
1,8,78,60,Virginia,18,2014,32
5,12,76,71,Virginia,5,2017,64
1,4,84,71,Virginia,13,2016,16
1,9,77,69,Virginia,8,2016,32
1,16,81,45,Virginia,36,2016,64
4,13,84,57,Virginia,27,2007,64
4,1,67,58,Virginia,9,1995,16
7,10,75,67,Virginia,8,1990,64
4,13,96,72,Virginia,24,1995,64
4,12,60,54,Virginia,6,1995,32
5,1,86,80,Virginia,6,1989,16
7,10,57,54,Virginia,3,1994,64
5,13,104,88,Virginia,16,1989,32
5,12,100,97,Virginia,3,1989,64
11,6,79,73,Central Mich.,6,2003,64
16,16,81,77,Robert Morris,4,2015,68
10,7,51,46,George Washington,5,1994,64
8,9,88,85,George Washington,3,2006,64
12,5,82,68,George Washington,14,1993,64
12,13,90,80,George Washington,10,1993,32
16,16,59,55,Holy Cross,4,2016,68
13,12,83,77,Valparaiso,6,1998,32
13,4,70,69,Valparaiso,1,1998,64
4,13,79,63,La Salle,16,1990,64
13,13,80,71,La Salle,9,2013,68
13,4,63,61,La Salle,2,2013,64
13,12,76,74,La Salle,2,2013,32
7,10,93,73,South Carolina,20,2017,64
7,3,70,50,South Carolina,20,2017,16
7,2,88,81,South Carolina,7,2017,32
7,4,77,70,South Carolina,7,2017,8
14,3,68,67,Austin Peay,1,1987,64
12,5,87,79,Montana,8,2006,64
10,7,71,58,Texas,13,1997,64
7,10,76,62,Texas,14,2009,64
4,13,79,67,Texas,12,2007,64
2,15,60,52,Texas,8,2006,64
2,6,74,71,Texas,3,2006,16
3,14,66,49,Texas,17,2004,64
2,10,75,54,Texas,21,2006,32
10,15,82,81,Texas,1,1997,32
3,6,78,75,Texas,3,2004,32
10,7,80,76,Texas,4,1996,64
1,7,85,76,Texas,9,2003,8
6,11,70,57,Texas,13,2002,64
10,6,102,89,Texas,13,1990,16
10,7,100,88,Texas,12,1990,64
10,2,73,72,Texas,1,1990,32
1,16,82,61,Texas,21,2003,64
1,5,82,78,Texas,4,2003,16
1,9,77,67,Texas,10,2003,32
6,3,68,64,Texas,4,2002,32
11,6,90,73,Texas,17,1995,64
4,13,85,81,Texas,4,2011,64
2,15,74,54,Texas,20,2008,64
7,10,87,85,Texas,2,2014,64
2,3,82,62,Texas,20,2008,16
6,11,91,77,Texas,14,1994,64
11,6,76,70,Texas,6,1989,64
2,7,75,72,Texas,3,2008,32
5,12,73,65,Texas,8,1991,64
5,12,77,61,Texas,16,2000,64
1,2,86,62,Massachusetts,24,1996,8
3,14,54,50,Massachusetts,4,1993,64
2,15,68,51,Massachusetts,17,1995,64
2,6,76,51,Massachusetts,25,1995,16
1,16,92,70,Massachusetts,22,1996,64
1,9,79,74,Massachusetts,5,1996,32
3,14,85,58,Massachusetts,27,1992,64
2,10,75,53,Massachusetts,22,1995,32
3,6,77,71,Massachusetts,6,1992,32
1,12,79,63,Massachusetts,16,1996,16
2,15,78,60,Massachusetts,18,1994,64
5,12,85,67,St. John's (NY),18,1993,64
6,11,81,65,St. John's (NY),16,1990,64
1,9,68,65,St. John's (NY),3,1985,32
1,3,69,60,St. John's (NY),9,1985,8
1,16,83,59,St. John's (NY),24,1985,64
1,12,86,70,St. John's (NY),16,1985,16
3,2,76,62,St. John's (NY),14,1999,16
3,14,69,43,St. John's (NY),26,1999,64
3,6,86,61,St. John's (NY),25,1999,32
6,11,57,55,St. John's (NY),2,1987,64
4,1,91,74,St. John's (NY),17,1991,16
4,13,75,68,St. John's (NY),7,1991,64
4,5,84,76,St. John's (NY),8,1991,32
1,16,83,74,St. John's (NY),9,1986,64
2,15,61,56,St. John's (NY),5,2000,64
3,14,66,63,Florida St.,3,2012,64
3,14,78,68,Florida St.,10,1992,64
3,6,78,68,Florida St.,10,1992,32
3,14,86,80,Florida St.,6,2017,64
7,10,75,72,Florida St.,3,1991,64
3,11,94,63,Florida St.,31,1993,32
3,14,82,70,Florida St.,12,1993,64
3,7,81,78,Florida St.,3,1993,16
12,5,96,87,Florida St.,9,1998,64
10,2,71,57,Florida St.,14,2011,32
10,7,57,50,Florida St.,7,2011,64
13,4,70,68,Indiana St.,2,2001,64
1,8,93,83,North Carolina,10,1998,32
1,5,63,57,North Carolina,6,1997,16
1,16,113,82,North Carolina,31,1987,64
2,11,81,63,North Carolina,18,2011,16
1,5,74,68,North Carolina,6,1987,16
1,4,80,74,North Carolina,6,1993,16
1,12,93,67,North Carolina,26,1991,16
1,9,73,56,North Carolina,17,1997,32
1,16,71,51,North Carolina,20,1994,64
1,16,86,65,North Carolina,21,2007,64
1,16,88,52,North Carolina,36,1998,64
1,16,101,66,North Carolina,35,1991,64
1,9,109,97,North Carolina,12,1987,32
1,9,81,67,North Carolina,14,2007,32
1,8,112,67,North Carolina,45,1993,32
1,6,97,74,North Carolina,23,1997,8
1,10,83,66,North Carolina,17,2016,4
1,9,85,66,North Carolina,19,2016,32
1,16,83,67,North Carolina,16,2016,64
1,2,78,68,North Carolina,10,1993,4
2,15,102,87,North Carolina,15,2011,64
1,9,84,69,North Carolina,15,1991,32
6,11,79,77,North Carolina,2,2014,64
2,7,86,83,North Carolina,3,2011,32
1,16,82,74,North Carolina,8,1997,64
1,5,74,64,North Carolina,10,2007,16
1,2,75,64,North Carolina,11,1998,8
1,16,113,74,North Carolina,39,2008,64
6,11,83,62,North Carolina,21,1996,64
1,16,85,65,North Carolina,20,1993,64
1,9,108,77,North Carolina,31,2008,32
1,6,88,74,North Carolina,14,2016,8
1,3,83,73,North Carolina,10,2008,8
1,1,77,71,North Carolina,6,1993,2
1,10,75,72,North Carolina,3,1991,8
1,5,101,86,North Carolina,15,2016,16
1,2,75,68,North Carolina,7,1993,8
1,4,68,47,North Carolina,21,2008,16
1,4,73,58,North Carolina,15,1998,16
6,11,63,52,North Carolina,11,2004,64
1,2,72,60,North Carolina,12,2009,8
1,2,89,72,North Carolina,17,2009,2
8,1,60,53,North Carolina,7,2000,32
8,4,74,69,North Carolina,5,2000,16
8,9,83,70,North Carolina,13,1990,64
8,9,84,70,North Carolina,14,2000,64
1,8,84,70,North Carolina,14,2009,32
1,4,98,77,North Carolina,21,2009,16
1,3,83,69,North Carolina,14,2009,4
1,16,101,58,North Carolina,43,2009,64
8,9,78,71,North Carolina,7,2013,64
1,13,73,65,North Carolina,8,2012,16
8,1,79,77,North Carolina,2,1990,32
8,7,59,55,North Carolina,4,2000,8
1,16,77,58,North Carolina,19,2012,64
1,8,87,73,North Carolina,14,2012,32
2,6,74,64,North Carolina,10,1995,16
1,1,71,65,North Carolina,6,2017,2
4,13,67,65,North Carolina,2,2015,64
2,15,80,70,North Carolina,10,1995,64
1,4,92,80,North Carolina,12,2017,16
1,5,67,66,North Carolina,1,2005,16
4,5,87,78,North Carolina,9,2015,32
2,15,70,48,North Carolina,22,2001,64
2,7,73,51,North Carolina,22,1995,32
2,15,93,79,North Carolina,14,1989,64
3,6,77,59,North Carolina,18,1986,32
3,14,84,72,North Carolina,12,1986,64
2,11,62,56,North Carolina,6,1985,16
1,16,96,68,North Carolina,28,2005,64
1,5,87,71,North Carolina,16,2005,4
1,3,77,76,North Carolina,1,2017,4
1,9,92,65,North Carolina,27,2005,32
1,16,103,64,North Carolina,39,2017,64
2,7,60,58,North Carolina,2,1985,32
1,6,88,82,North Carolina,6,2005,8
1,8,72,65,North Carolina,7,2017,32
2,3,78,69,North Carolina,9,1988,16
1,2,75,73,North Carolina,2,2017,8
2,15,83,65,North Carolina,18,1988,64
3,14,69,65,North Carolina,4,2006,64
4,13,68,63,North Carolina,5,1992,64
1,1,75,70,North Carolina,5,2005,2
2,7,88,81,North Carolina,7,1989,32
4,5,64,55,North Carolina,9,1992,32
2,10,123,97,North Carolina,26,1988,32
2,1,74,61,North Carolina,13,1995,8
2,15,76,57,North Carolina,19,1985,64
1,2,90,82,Maryland,8,2002,8
1,4,78,68,Maryland,10,2002,16
1,5,64,52,Maryland,12,2002,2
1,8,87,57,Maryland,30,2002,32
1,16,85,70,Maryland,15,2002,64
1,1,97,88,Maryland,9,2002,4
3,14,83,80,Maryland,3,2001,64
3,14,87,63,Maryland,24,1995,64
3,11,79,60,Maryland,19,2001,32
4,5,67,61,Maryland,6,1998,32
4,13,86,83,Maryland,3,2004,64
6,3,77,64,Maryland,13,2003,32
3,1,87,73,Maryland,14,2001,8
3,11,82,68,Maryland,14,1995,32
4,13,82,68,Maryland,14,1998,64
6,11,75,73,Maryland,2,2003,64
3,10,76,66,Maryland,10,2001,16
4,13,82,70,Maryland,12,2007,64
2,15,82,60,Maryland,22,1999,64
4,13,65,62,Maryland,3,2015,64
5,12,79,74,Maryland,5,2016,64
10,7,74,66,Maryland,8,1994,64
7,10,92,82,Maryland,10,1988,64
2,10,75,63,Maryland,12,1999,32
3,14,74,59,Maryland,15,2000,64
5,13,73,60,Maryland,13,2016,32
10,2,95,87,Maryland,8,1994,32
4,13,89,77,Maryland,12,2010,64
5,12,69,68,Maryland,1,1985,64
10,7,84,71,Maryland,13,2009,64
5,13,64,59,Maryland,5,1985,32
5,12,69,64,Maryland,5,1986,64
7,10,77,71,Nevada,6,2007,64
9,8,61,57,Nevada,4,2005,64
10,7,72,66,Nevada,6,2004,64
10,2,91,72,Nevada,19,2004,32
14,3,87,80,ETSU,7,1992,64
16,16,71,59,Vermont,12,2012,68
13,4,60,57,Vermont,3,2005,64
5,12,79,70,Vanderbilt,9,2012,64
6,3,78,74,Vanderbilt,4,2007,32
6,11,77,44,Vanderbilt,33,2007,64
7,2,80,74,Vanderbilt,6,1988,32
7,10,80,77,Vanderbilt,3,1988,64
6,3,75,73,Vanderbilt,2,2004,32
6,11,71,58,Vanderbilt,13,2004,64
3,6,85,68,Vanderbilt,17,1993,32
3,14,92,72,Vanderbilt,20,1993,64
11,6,55,53,Tulane,2,1993,64
9,8,76,70,Tulane,6,1995,64
10,7,61,57,Tulane,4,1992,64
2,15,75,54,Miami (FL),21,1999,64
2,7,63,59,Miami (FL),4,2013,32
2,15,78,49,Miami (FL),29,2013,64
6,3,75,62,Miami (FL),13,2000,32
6,11,75,71,Miami (FL),4,2000,64
3,14,79,72,Miami (FL),7,2016,64
3,11,65,57,Miami (FL),8,2016,32
7,10,78,64,Miami (FL),14,2008,64
7,2,97,85,Navy,12,1986,32
7,14,71,70,Navy,1,1986,16
7,10,87,68,Navy,19,1986,64
13,4,78,55,Navy,23,1985,64
4,12,60,49,Xavier,11,2009,32
2,15,71,53,Xavier,18,2016,64
4,13,77,59,Xavier,18,2009,64
7,10,80,70,Xavier,10,2004,64
7,2,89,74,Xavier,15,2004,32
7,3,79,71,Xavier,8,2004,16
11,3,91,66,Xavier,25,2017,32
9,8,73,55,Xavier,18,1993,64
11,2,73,71,Xavier,2,2017,16
3,14,71,59,Xavier,12,2003,64
6,3,74,71,Xavier,3,1990,32
11,6,76,65,Xavier,11,2017,64
6,11,87,79,Xavier,8,1990,64
9,8,79,77,Xavier,2,2007,64
14,3,89,84,Xavier,5,1991,64
10,7,67,63,Xavier,4,2012,64
7,10,80,68,Xavier,12,1997,64
10,15,70,58,Xavier,12,2012,32
13,4,70,69,Xavier,1,1987,64
3,7,79,75,Xavier,4,2008,16
6,11,76,57,Xavier,19,2015,64
3,6,85,78,Xavier,7,2008,32
6,11,65,54,Xavier,11,2010,64
6,3,71,68,Xavier,3,2010,32
3,14,73,61,Xavier,12,2008,64
7,10,70,58,Xavier,12,2002,64
6,14,75,67,Xavier,8,2015,32
7,10,83,79,New Orleans,4,1987,64
12,4,65,56,Arkansas,9,1996,32
9,8,86,72,Arkansas,14,2008,64
4,13,94,64,Arkansas,30,1993,64
4,5,80,74,Arkansas,6,1993,32
12,5,86,80,Arkansas,6,1996,64
9,8,63,54,Arkansas,9,1985,64
1,4,93,70,Arkansas,23,1991,16
1,8,97,90,Arkansas,7,1991,32
1,16,117,76,Arkansas,41,1991,64
4,8,96,73,Arkansas,23,1990,16
4,13,68,64,Arkansas,4,1990,64
6,11,74,65,Arkansas,9,1998,64
4,12,86,84,Arkansas,2,1990,32
4,10,88,85,Arkansas,3,1990,8
1,3,76,68,Arkansas,8,1994,8
5,12,120,101,Arkansas,19,1989,64
1,12,103,84,Arkansas,19,1994,16
1,16,94,79,Arkansas,15,1994,64
2,4,68,61,Arkansas,7,1995,8
1,9,85,73,Arkansas,12,1994,32
2,2,75,68,Arkansas,7,1995,4
1,2,91,82,Arkansas,9,1994,4
2,7,96,94,Arkansas,2,1995,32
1,2,76,72,Arkansas,4,1994,2
3,14,80,69,Arkansas,11,1992,64
2,15,79,78,Arkansas,1,1995,64
2,6,96,91,Arkansas,5,1995,16
8,9,77,71,Arkansas,6,2017,64
4,13,94,80,Arkansas,14,1999,64
5,12,56,53,Arkansas,3,2015,64
6,11,66,57,Arizona St.,9,2009,64
8,9,79,76,Arizona St.,3,1991,64
5,12,81,66,Arizona St.,15,1995,64
5,13,64,54,Arizona St.,10,1995,32
10,7,84,71,Arizona St.,13,2003,64
2,15,72,57,Tennessee,15,2008,64
2,7,76,71,Tennessee,5,2008,32
4,13,62,52,Tennessee,10,1999,64
4,13,63,58,Tennessee,5,2000,64
4,5,65,51,Tennessee,14,2000,32
5,4,77,74,Tennessee,3,2007,32
5,12,121,86,Tennessee,35,2007,64
11,14,83,63,Tennessee,20,2014,32
6,11,62,59,Tennessee,3,2010,64
11,6,86,67,Tennessee,19,2014,64
6,14,83,68,Tennessee,15,2010,32
11,11,78,65,Tennessee,13,2014,68
6,2,76,73,Tennessee,3,2010,16
2,15,63,61,Tennessee,2,2006,64
9,8,97,82,Michigan,15,1987,64
11,11,67,62,Michigan,5,2016,68
4,5,78,53,Michigan,25,2013,32
10,7,62,59,Michigan,3,2009,64
8,9,75,45,Michigan,30,2011,64
4,3,79,59,Michigan,20,2013,8
2,15,70,64,Michigan,6,1986,64
4,4,61,56,Michigan,5,2013,4
4,13,71,56,Michigan,15,2013,64
4,1,87,85,Michigan,2,2013,16
3,6,84,79,Michigan,5,1994,32
3,10,78,71,Michigan,7,1994,16
2,15,57,40,Michigan,17,2014,64
2,7,79,65,Michigan,14,2014,32
7,2,73,69,Michigan,4,2017,32
3,14,78,74,Michigan,4,1994,64
7,10,92,91,Michigan,1,2017,64
2,11,73,71,Michigan,2,2014,16
6,2,75,72,Michigan,3,1992,16
3,14,76,70,Michigan,6,1990,64
1,1,81,78,Michigan,3,1993,4
3,14,63,58,Michigan,5,1988,64
3,1,83,81,Michigan,2,1989,4
6,4,76,72,Michigan,4,1992,4
1,12,72,64,Michigan,8,1993,16
3,14,80,61,Michigan,19,1998,64
6,1,75,71,Michigan,4,1992,8
3,5,102,65,Michigan,37,1989,8
3,6,108,85,Michigan,23,1988,32
1,16,84,52,Michigan,32,1993,64
3,14,92,87,Michigan,5,1989,64
1,7,77,72,Michigan,5,1993,8
1,9,86,84,Michigan,2,1993,32
3,3,80,79,Michigan,1,1989,2
3,11,91,82,Michigan,9,1989,32
3,2,92,87,Michigan,5,1989,16
6,11,73,66,Michigan,7,1992,64
1,16,59,55,Michigan,4,1985,64
6,14,102,90,Michigan,12,1992,32
12,4,74,69,DePaul,5,1986,32
12,5,72,68,DePaul,4,1986,64
12,5,66,63,DePaul,3,1989,64
5,12,83,62,DePaul,21,1988,64
7,10,76,69,DePaul,7,2004,64
3,14,76,62,DePaul,14,1987,64
3,6,83,75,DePaul,8,1987,32
2,15,90,69,Duke,21,1989,64
1,9,97,56,Duke,41,1999,32
1,16,99,58,Duke,41,1999,64
2,1,85,77,Duke,8,1989,8
2,15,85,69,Duke,16,1988,64
1,9,94,81,Duke,13,2001,32
1,1,68,62,Duke,6,1999,4
3,6,76,72,Duke,4,1990,32
1,3,95,84,Duke,11,2001,4
1,12,78,61,Duke,17,1999,16
2,11,73,72,Duke,1,1988,16
1,16,82,56,Duke,26,1992,64
3,7,90,81,Duke,9,1990,16
1,16,70,54,Duke,16,2006,64
2,11,87,70,Duke,17,1989,16
3,4,97,83,Duke,14,1990,4
1,7,71,50,Duke,21,1986,8
1,6,79,69,Duke,10,2001,8
2,15,87,65,Duke,22,2017,64
1,4,76,63,Duke,13,2001,16
1,16,82,55,Duke,27,2000,64
1,8,74,61,Duke,13,2006,32
1,16,95,52,Duke,43,2001,64
1,5,72,62,Duke,10,2004,16
1,16,85,78,Duke,7,1986,64
2,7,70,63,Duke,7,1989,32
1,7,66,63,Duke,3,2004,8
3,14,81,46,Duke,35,1990,64
1,8,89,61,Duke,28,1986,32
1,4,81,69,Duke,12,1992,16
1,6,71,51,Duke,20,1992,2
1,1,71,67,Duke,4,1986,4
1,2,82,72,Duke,10,2001,2
2,1,63,53,Duke,10,1988,8
2,7,94,79,Duke,15,1988,32
1,8,69,64,Duke,5,2000,32
3,1,79,78,Duke,1,1990,8
2,15,86,62,Duke,24,2009,64
1,2,104,103,Duke,1,1992,8
1,12,74,67,Duke,7,1986,16
1,2,81,78,Duke,3,1992,4
1,9,75,62,Duke,13,1992,32
1,8,90,62,Duke,28,2004,32
2,7,74,69,Duke,5,2009,32
1,6,85,64,Duke,21,1999,8
1,16,96,61,Duke,35,2004,64
3,14,105,70,Duke,35,1993,64
2,1,69,60,Duke,9,1994,8
2,6,59,49,Duke,10,1994,16
1,2,78,57,Duke,21,2010,4
1,3,78,71,Duke,7,2010,8
1,16,73,44,Duke,29,2010,64
1,16,85,56,Duke,29,2015,64
2,3,70,65,Duke,5,1994,4
2,7,85,74,Duke,11,1994,32
2,15,71,68,Duke,3,1997,64
1,1,68,63,Duke,5,2015,2
1,8,73,71,Duke,2,2011,32
1,16,87,45,Duke,42,2011,64
1,5,63,57,Duke,6,2015,16
2,15,82,70,Duke,12,1994,64
1,5,61,59,Duke,2,2010,2
1,2,66,52,Duke,14,2015,8
1,4,70,57,Duke,13,2010,16
1,7,81,61,Duke,20,2015,4
1,8,68,53,Duke,15,2010,32
1,8,68,49,Duke,19,2015,32
1,8,84,77,Duke,7,2002,32
2,4,78,61,Duke,17,1991,8
1,9,63,55,Duke,8,2005,32
2,1,79,77,Duke,2,1991,4
2,7,85,70,Duke,15,1991,32
5,13,65,60,Duke,5,1987,32
1,16,57,46,Duke,11,2005,64
2,15,102,73,Duke,29,1991,64
3,14,75,62,Duke,13,1985,64
1,16,84,37,Duke,47,2002,64
5,12,58,51,Duke,7,1987,64
2,3,71,61,Duke,10,2013,16
2,7,66,50,Duke,16,2013,32
2,3,72,65,Duke,7,1991,2
2,15,73,61,Duke,12,2013,64
2,11,81,67,Duke,14,1991,16
4,12,71,64,Duke,7,2016,32
2,15,71,70,Duke,1,2008,64
3,11,86,60,Duke,26,2003,32
4,13,93,85,Duke,8,2016,64
1,8,79,73,Duke,6,1998,32
1,16,99,63,Duke,36,1998,64
1,5,80,67,Duke,13,1998,16
3,14,67,57,Duke,10,2003,64
16,16,71,64,Albany (NY),7,2014,68
10,7,64,62,Western Ky.,2,1987,64
12,5,76,72,Western Ky.,4,2009,64
16,16,59,58,Western Ky.,1,2012,68
8,9,67,59,Western Ky.,8,1986,64
8,9,82,76,Western Ky.,6,1995,64
7,2,72,68,Western Ky.,4,1993,32
7,10,55,52,Western Ky.,3,1993,64
12,5,101,99,Western Ky.,2,2008,64
12,13,72,63,Western Ky.,9,2008,32
14,3,70,56,SFA,14,2016,64
12,5,77,75,SFA,2,2014,64
6,3,71,69,Texas Tech,2,2005,32
3,14,74,73,Texas Tech,1,1996,64
3,6,92,73,Texas Tech,19,1996,32
6,11,78,66,Texas Tech,12,2005,64
8,9,76,73,Texas Tech,3,2004,64
16,16,70,61,UTSA,9,2011,68
15,2,90,81,Middle Tenn.,9,2016,64
12,5,81,72,Middle Tenn.,9,2017,64
13,4,97,83,Middle Tenn.,14,1989,64
10,7,58,54,Purdue,4,1999,64
10,2,73,63,Purdue,10,1999,32
3,14,104,95,Purdue,9,1987,64
1,9,83,73,Purdue,10,1994,32
4,13,72,64,Purdue,8,2010,64
1,4,83,78,Purdue,5,1994,16
8,9,83,76,Purdue,7,1997,64
2,15,75,63,Purdue,12,1990,64
9,8,80,56,Purdue,24,2003,64
1,9,100,73,Purdue,27,1988,32
1,16,94,79,Purdue,15,1988,64
1,16,98,67,Purdue,31,1994,64
10,7,72,69,Purdue,3,2012,64
4,5,63,61,Purdue,2,2010,32
3,14,49,48,Purdue,1,1995,64
2,15,95,56,Purdue,39,1998,64
2,10,80,65,Purdue,15,1998,32
9,8,72,63,Purdue,9,2007,64
4,5,80,76,Purdue,4,2017,32
4,13,80,70,Purdue,10,2017,64
6,3,66,62,Purdue,4,2000,32
3,14,65,43,Purdue,22,2011,64
1,16,73,71,Purdue,2,1996,64
5,4,76,74,Purdue,2,2009,32
5,12,61,56,Purdue,5,2009,64
6,10,75,66,Purdue,9,2000,16
6,11,90,79,Purdue,11,2008,64
6,11,62,61,Purdue,1,2000,64
5,12,91,85,Alabama,6,1995,64
7,10,50,41,Alabama,9,1985,64
4,5,96,88,Alabama,8,1991,32
8,5,80,71,Alabama,9,2004,16
8,9,65,64,Alabama,1,2004,64
4,13,89,79,Alabama,10,1991,64
2,15,88,71,Alabama,17,1987,64
2,7,101,76,Alabama,25,1987,32
8,1,70,67,Alabama,3,2004,32
9,8,76,70,Alabama,6,1994,64
7,2,63,59,Alabama,4,1985,32
10,7,90,85,Alabama,5,2006,64
5,12,97,80,Alabama,17,1986,64
2,15,86,78,Alabama,8,2002,64
5,4,58,56,Alabama,2,1986,32
5,12,80,75,Alabama,5,1992,64
7,10,71,54,Alabama,17,1990,64
7,2,77,55,Alabama,22,1990,32
9,8,65,63,California,2,1990,64
5,12,55,52,California,3,1997,64
5,4,75,68,California,7,1997,32
8,9,76,74,California,2,2003,64
12,5,64,61,California,3,2013,64
6,3,82,77,California,5,1993,32
6,11,66,64,California,2,1993,64
8,9,77,62,California,15,2010,64
6,11,82,75,California,7,2002,64
16,16,61,44,Ark.-Pine Bluff,17,2010,68
4,13,76,60,TCU,16,1987,64
5,12,84,76,West Virginia,8,2011,64
7,10,63,61,West Virginia,2,2005,64
2,15,77,50,West Virginia,27,2010,64
2,10,68,59,West Virginia,9,2010,32
2,11,69,56,West Virginia,13,2010,16
6,14,67,54,West Virginia,13,2006,32
7,2,111,105,West Virginia,6,2005,32
7,6,65,60,West Virginia,5,2005,16
6,11,64,46,West Virginia,18,2006,64
2,1,73,66,West Virginia,7,2010,8
7,10,84,68,West Virginia,16,1989,64
10,7,82,52,West Virginia,30,1998,64
4,13,86,80,West Virginia,6,2017,64
10,2,75,74,West Virginia,1,1998,32
4,5,83,71,West Virginia,12,2017,32
5,4,69,59,West Virginia,10,2015,32
5,12,68,62,West Virginia,6,2015,64
7,10,75,65,West Virginia,10,2008,64
7,2,73,67,West Virginia,6,2008,32
16,16,69,60,Mt. St. Mary's,9,2008,68
16,16,67,66,Mt. St. Mary's,1,2017,68
1,16,79,47,Wake Forest,32,1995,64
2,15,76,73,Wake Forest,3,2003,64
2,15,70,54,Wake Forest,16,2005,64
1,9,64,59,Wake Forest,5,1995,32
9,8,81,80,Wake Forest,1,2010,64
5,12,71,65,Wake Forest,6,1991,64
2,10,65,62,Wake Forest,3,1996,32
2,15,62,50,Wake Forest,12,1996,64
5,12,68,58,Wake Forest,10,1994,64
2,6,60,59,Wake Forest,1,1996,16
7,10,83,74,Wake Forest,9,2002,64
4,13,79,78,Wake Forest,1,2004,64
5,12,81,58,Wake Forest,23,1993,64
5,4,84,78,Wake Forest,6,1993,32
4,12,84,80,Wake Forest,4,2004,32
3,14,68,46,Wake Forest,22,1997,64
11,6,66,55,Marquette,11,2011,64
3,2,71,61,Marquette,10,2013,16
3,14,59,58,Marquette,1,2013,64
3,6,74,72,Marquette,2,2013,32
11,3,66,62,Marquette,4,2011,32
4,13,68,44,Marquette,24,1996,64
6,11,81,59,Marquette,22,1994,64
6,3,75,63,Marquette,12,1994,32
3,2,77,74,Marquette,3,2003,16
3,1,83,69,Marquette,14,2003,8
3,14,72,68,Marquette,4,2003,64
3,6,101,92,Marquette,9,2003,32
6,11,74,66,Marquette,8,2008,64
3,14,88,68,Marquette,20,2012,64
3,6,62,53,Marquette,9,2012,32
6,11,58,57,Marquette,1,2009,64
13,4,74,69,Penn St.,5,1991,64
7,10,69,59,Penn St.,10,2001,64
7,2,82,74,Penn St.,8,2001,32
16,16,77,69,Niagara,8,2007,68
13,4,87,83,Louisiana,4,1992,64
5,12,68,50,Notre Dame,18,2008,64
6,7,61,56,Notre Dame,5,2016,16
6,14,76,75,Notre Dame,1,2016,32
9,8,81,65,Notre Dame,16,1989,64
5,4,58,57,Notre Dame,1,1987,32
5,12,84,71,Notre Dame,13,1987,64
6,11,70,63,Notre Dame,7,2016,64
5,12,60,58,Notre Dame,2,2017,64
3,6,67,64,Notre Dame,3,2015,32
3,7,81,70,Notre Dame,11,2015,16
6,11,83,71,Notre Dame,12,2001,64
8,9,82,63,Notre Dame,19,2002,64
3,14,69,65,Notre Dame,4,2015,64
7,10,79,70,Notre Dame,9,1985,64
5,12,70,69,Notre Dame,1,2003,64
2,15,69,56,Notre Dame,13,2011,64
5,4,68,60,Notre Dame,8,2003,32
13,4,77,73,Kent St.,4,2001,64
10,7,69,61,Kent St.,8,2002,64
10,3,78,73,Kent St.,5,2002,16
10,2,71,58,Kent St.,13,2002,32
11,14,80,67,Minnesota,13,1989,32
11,6,86,75,Minnesota,11,1989,64
11,6,83,63,Minnesota,20,2013,64
1,16,78,46,Minnesota,32,1997,64
6,11,64,61,Minnesota,3,1990,64
1,2,80,72,Minnesota,8,1997,8
1,4,90,84,Minnesota,6,1997,16
1,9,76,57,Minnesota,19,1997,32
6,2,82,75,Minnesota,7,1990,16
6,14,81,78,Minnesota,3,1990,32
6,11,74,60,Minnesota,14,1994,64
15,2,75,70,Lehigh,5,2012,64
2,15,65,58,Georgia Tech,7,1985,64
5,12,90,78,Georgia Tech,12,1988,64
5,12,80,68,Georgia Tech,12,2005,64
2,7,70,53,Georgia Tech,17,1985,32
2,3,61,53,Georgia Tech,8,1985,16
3,11,103,89,Georgia Tech,14,1996,32
2,10,66,61,Georgia Tech,5,1986,32
3,14,90,79,Georgia Tech,11,1996,64
2,15,68,53,Georgia Tech,15,1986,64
10,7,64,59,Georgia Tech,5,2010,64
4,6,93,91,Georgia Tech,2,1990,8
4,1,81,80,Georgia Tech,1,1990,16
8,9,87,70,Georgia Tech,17,1991,64
4,13,99,83,Georgia Tech,16,1990,64
7,10,65,60,Georgia Tech,5,1992,64
7,2,79,78,Georgia Tech,1,1992,32
4,5,94,91,Georgia Tech,3,1990,32
3,2,67,65,Georgia Tech,2,2004,4
3,6,57,54,Georgia Tech,3,2004,32
3,4,79,71,Georgia Tech,8,2004,8
3,10,72,67,Georgia Tech,5,2004,16
3,14,65,60,Georgia Tech,5,2004,64
3,14,76,57,Illinois,19,1985,64
4,13,68,58,Illinois,10,2000,64
5,12,72,53,Illinois,19,2004,64
3,6,74,58,Illinois,16,1985,32
5,4,92,68,Illinois,24,2004,32
7,10,57,49,Illinois,8,2013,64
4,13,93,64,Illinois,29,2002,64
1,12,77,63,Illinois,14,2005,16
1,16,67,55,Illinois,12,2005,64
4,12,72,60,Illinois,12,2002,32
1,9,71,59,Illinois,12,2005,32
1,4,72,57,Illinois,15,2005,4
1,3,90,89,Illinois,1,2005,8
5,12,64,51,Illinois,13,1998,64
6,11,90,77,Illinois,13,1997,64
1,4,80,64,Illinois,16,2001,16
1,16,96,54,Illinois,42,2001,64
1,9,72,60,Illinois,12,1989,32
1,16,77,71,Illinois,6,1989,64
1,4,83,69,Illinois,14,1989,16
1,9,79,61,Illinois,18,2001,32
1,2,89,86,Illinois,3,1989,8
4,13,75,51,Illinois,24,1986,64
3,14,81,72,Illinois,9,1988,64
6,11,75,72,Illinois,3,1993,64
4,13,65,60,Illinois,5,2003,64
4,13,78,69,Illinois,9,2006,64
9,8,73,62,Illinois,11,2011,64
16,16,79,69,Oakland,10,2005,68
6,14,64,52,Tulsa,12,1995,32
6,11,68,62,Tulsa,6,1995,64
9,8,62,53,Tulsa,9,1999,64
12,5,71,69,Tulsa,2,2002,64
7,6,80,71,Tulsa,9,2000,16
7,10,89,62,Tulsa,27,2000,64
7,2,69,61,Tulsa,8,2000,32
12,5,112,102,Tulsa,10,1994,64
5,12,81,52,Tulsa,29,1997,64
13,4,84,71,Tulsa,13,2003,64
12,4,82,80,Tulsa,2,1994,32